Smart Contract, Total Opcodes, Total Jumps, Solved Jumps, Definitely unreachable jumps, Maybe unreachable jumps, Total solved Jumps, Unsound jumps, Maybe unsound jumps, % Total Solved, Time (millis), Notes 
0x1ca02e3862da25648ef85191414773b71176a82b, 1517, 108, 106, 2, 0, 108, 0, 0, 1.0, 63795, ss: 128 sss: 32 
0xd3c474b0012fffc87d9ea1ab56fbe260ce240bad, 1520, 107, 106, 1, 0, 107, 0, 0, 1.0, 63907, ss: 128 sss: 32 
0x1ec364CDD9697F56B8CB17a745B98C2b862CBE29, 2155, 146, 142, 4, 0, 146, 0, 0, 1.0, 33732, ss: 128 sss: 32 
0x38c48c3d8d88c17281462e39192615cdc25fe630, 250, 18, 18, 0, 0, 18, 0, 0, 1.0, 1645, ss: 128 sss: 32 
0xa09a3e90da9574a43d35b893277ed6b3df79e88f, 2038, 151, 150, 1, 0, 151, 0, 0, 1.0, 74756, ss: 128 sss: 32 
0x149fd5d3db341277b7d1821b744996bf0077e5ed, 2444, 179, 178, 1, 0, 179, 0, 0, 1.0, 79127, ss: 128 sss: 32 
0xa1b0f267cf5eab73eefdcaf1c52704772f99a37f, 1023, 84, 81, 3, 0, 84, 0, 0, 1.0, 38715, ss: 128 sss: 32 
0xF9D2ec4b9b44B141097489CBf00C59c974c49238, 2204, 163, 159, 4, 0, 163, 0, 0, 1.0, 170986, ss: 128 sss: 32 
0x8012d769c438f106604c64d16e6287af9323deab, 1580, 108, 108, 0, 0, 108, 0, 0, 1.0, 60192, ss: 128 sss: 32 
0x1a374e8e1fd02a1ce0fb9bc4f58cde7bbab41ebe, 2428, 226, 215, 11, 0, 226, 0, 0, 1.0, 111965, ss: 128 sss: 32 
0x2aecf16ea4b4036123f43da94cf4e3e4d0a2a293, 1823, 90, 89, 1, 0, 90, 0, 0, 1.0, 4967, ss: 128 sss: 32 
0xF87D45488590EB00aaA052f96a253a505c4fC08C, 1982, 157, 150, 7, 0, 157, 0, 0, 1.0, 30291, ss: 128 sss: 32 
0x46Fa005E07e51732778A3745145B0D29AD5d7167, 1937, 100, 87, 13, 0, 100, 0, 0, 1.0, 914, ss: 128 sss: 32 
0xc1024ef7448186d4792d7dec5497fe8d4241687c, 2017, 166, 156, 10, 0, 166, 0, 1, 1.0, 9408, ss: 128 sss: 32 
0x9C1E6d460426a5e5355B337F67B5e4ffE916765E, 2392, 211, 208, 3, 0, 211, 0, 0, 1.0, 60797, ss: 128 sss: 32 
0x6d4fe830363c6af29147422fae4bc38e89b90af7, 1366, 96, 95, 1, 0, 96, 0, 0, 1.0, 34442, ss: 128 sss: 32 
0x817f844137e9f95da69299dfc2fb99ba9dbf5223, 1381, 99, 98, 1, 0, 99, 0, 0, 1.0, 42793, ss: 128 sss: 32 
0x07bf306aade228919b123d799c075d2ba627ad79, 1840, 133, 132, 1, 0, 133, 0, 0, 1.0, 37838, ss: 128 sss: 32 
0xed881fdc86fd928c48f199ac0d4f95e104011611, 2044, 190, 189, 1, 0, 190, 0, 0, 1.0, 172632, ss: 128 sss: 32 
0x024084d60a5fE572620aE9CE3178471F8fEEFfD2, 2513, 251, 248, 3, 0, 251, 0, 0, 1.0, 139927, ss: 128 sss: 32 
0x527cceba71b243f9c44f87ec0f236273313b285d, 1517, 108, 106, 2, 0, 108, 0, 0, 1.0, 41943, ss: 128 sss: 32 
0x2Ece2318109E56459Cba4788695B349ACCDA5841, 2931, 273, 256, 17, 0, 273, 0, 0, 1.0, 139812, ss: 128 sss: 32 
0xa57019c911cf94ed52baba1a943876eebc659499, 1512, 107, 106, 1, 0, 107, 0, 0, 1.0, 68568, ss: 128 sss: 32 
0xa54d90d8132edef66599196fbc4f1b95702508bf, 536, 40, 40, 0, 0, 40, 0, 0, 1.0, 308, ss: 128 sss: 32 
0xe22c1226d88672595aec3d476053140465638228, 1586, 107, 106, 1, 0, 107, 0, 0, 1.0, 41986, ss: 128 sss: 32 
0x6e42d3ed56413e5737129be488884d8e6b81ba2d, 1499, 116, 115, 1, 0, 116, 0, 0, 1.0, 23956, ss: 128 sss: 32 
0x1132490e28b2a398ed79e2e57238ea91957e1da7, 1596, 108, 106, 2, 0, 108, 0, 0, 1.0, 40306, ss: 128 sss: 32 
0x9199235ef044527f1eff1e4d9ba5c16243c9dfb9, 1511, 107, 106, 1, 0, 107, 0, 0, 1.0, 69757, ss: 128 sss: 32 
0xec64111A09AB3FD98dE13A6DB322ebff95D3414D, 2960, 213, 207, 6, 0, 213, 0, 0, 1.0, 62649, ss: 128 sss: 32 
0x6556f0936ac7a6a72a626614aac5444f4fc63037, 2300, 159, 155, 4, 0, 159, 0, 0, 1.0, 115461, ss: 128 sss: 32 
0x411eB08eD51086C23e7842C25B5006b598dC7D48, 2389, 229, 220, 9, 0, 229, 0, 0, 1.0, 113797, ss: 128 sss: 32 
0xdc597a5fd1f90d2b529c7862f3eab5cbad2c6ce2, 207, 22, 22, 0, 0, 22, 0, 0, 1.0, 252, ss: 128 sss: 32 
0xf689818d07ac53488ced7fca5a79e1456a7d4695, 1056, 75, 75, 0, 0, 75, 0, 0, 1.0, 34429, ss: 128 sss: 32 
0x9264Ac4E52EDdb5D0fb345CAE8E47A8b420a96fd, 936, 62, 62, 0, 0, 62, 0, 0, 1.0, 7923, ss: 128 sss: 32 
0x9d99fFb4b2889A96bea82e360e264e29A17f60C6, 2931, 273, 256, 17, 0, 273, 0, 0, 1.0, 142737, ss: 128 sss: 32 
0x88b0d61be1092a0aed7d5d0393246a242c5899f6, 961, 83, 83, 0, 0, 83, 0, 0, 1.0, 19581, ss: 128 sss: 32 
0x3311ad94f1bb66a78dd073b3c7fad6619c551e01, 1789, 151, 139, 12, 0, 151, 0, 0, 1.0, 3236, ss: 128 sss: 32 
0x10bf82fe7c65f7c222b67cb2b5d84e0150cbebd9, 1394, 110, 110, 0, 0, 110, 0, 0, 1.0, 32787, ss: 128 sss: 32 
0x69192971A09737A24d292e37F7ecfD57B40a5451, 2447, 188, 187, 1, 0, 188, 0, 0, 1.0, 74318, ss: 128 sss: 32 
0xdc68035552302d8b3dcb9aa5c57e97c843a0ac49, 2006, 143, 139, 4, 0, 143, 0, 0, 1.0, 21115, ss: 128 sss: 32 
0xAd54248e5D60b038D64e0571AAA4BfF64087A40d, 2466, 178, 171, 7, 0, 178, 0, 0, 1.0, 22436, ss: 128 sss: 32 
0xf60374ae350b112c429475065937079fcf59879a, 2573, 182, 175, 7, 0, 182, 0, 0, 1.0, 37001, ss: 128 sss: 32 
0x3B115AbA8D09d18dc80b0CA9fDC925BdF3606A5d, 2826, 262, 242, 20, 0, 262, 0, 0, 1.0, 53119, ss: 128 sss: 32 
0xe7dcb55aad6e71e01a040fe0ed11a22ad13194b8, 2307, 158, 154, 4, 0, 158, 0, 0, 1.0, 100335, ss: 128 sss: 32 
0xdf3a6e9bb8980666d4b6e94897487715f6b96132, 1517, 107, 106, 1, 0, 107, 0, 0, 1.0, 36094, ss: 128 sss: 32 
0x564D33cF8623D38Bd8D2D8a4AD152Bcd1BBb91Ae, 2868, 247, 233, 14, 0, 247, 0, 0, 1.0, 98180, ss: 128 sss: 32 
0xe3efc8bacda7b19f5d51c5daab9af682b2a66744, 2481, 126, 104, 22, 0, 126, 0, 0, 1.0, 584, ss: 128 sss: 32 
0x24c3a5d950aa0078dc8e4d5ec581d03c6681c7ca, 1512, 107, 106, 1, 0, 107, 0, 0, 1.0, 51978, ss: 128 sss: 32 
0x967a66a88a3b12224dd3ea520ee3b7e332da9dae, 1515, 107, 106, 1, 0, 107, 0, 0, 1.0, 56207, ss: 128 sss: 32 
0x5609b3debc687287ea5f082c1bb5281bd28ea1f6, 1515, 107, 106, 1, 0, 107, 0, 0, 1.0, 51714, ss: 128 sss: 32 
0xb8da770db50143210d6904f30e9468c6e80446ef, 2862, 276, 264, 12, 0, 276, 0, 0, 1.0, 151949, ss: 128 sss: 32 
0x1003ea3d5b46cc7c34f41a9c5128761cc60abf00, 2422, 226, 215, 11, 0, 226, 0, 0, 1.0, 102089, ss: 128 sss: 32 
0x1bbd6e11c0538f25633979f36a407582f8a34c7d, 2423, 207, 196, 11, 0, 207, 0, 0, 1.0, 41659, ss: 128 sss: 32 
0x118492053f229e52da35c4095e255b6a245c2e34, 2843, 262, 242, 20, 0, 262, 0, 0, 1.0, 50643, ss: 128 sss: 32 
0x203b87e9b22a1b27a684cdb923d7646b12e39760, 298, 23, 23, 0, 0, 23, 0, 0, 1.0, 847, ss: 128 sss: 32 
0x57e5112c8741fa606e344c19a73679a671a8ffd2, 1515, 107, 106, 1, 0, 107, 0, 0, 1.0, 33837, ss: 128 sss: 32 
0x00000000006756ce25b95124e0FC879Cc2B7F1DA, 1686, 164, 164, 0, 0, 164, 0, 0, 1.0, 14034, ss: 128 sss: 32 
0x2bcdb73866d4a40a5fb9ef98e501dc1c0d95292c, 1388, 110, 110, 0, 0, 110, 0, 0, 1.0, 37437, ss: 128 sss: 32 
0x8e693413d05ce5f7733b1a4b003af607e86ac5ba, 2376, 208, 193, 15, 0, 208, 0, 0, 1.0, 64527, ss: 128 sss: 32 
0x0fd49f8ab613492c3f4b009106d9e479118e0fea, 1929, 173, 165, 8, 0, 173, 0, 0, 1.0, 65340, ss: 128 sss: 32 
0xe1e76d558689a900d25f5d816bd5257002980294, 1531, 107, 106, 1, 0, 107, 0, 0, 1.0, 72789, ss: 128 sss: 32 
0x4822D77A2D328115C4edEbe1c82F313b28f8c315, 882, 61, 61, 0, 0, 61, 0, 1, 1.0, 8289, ss: 128 sss: 32 
0xbbA444b7201AfE9911BeA144907187EbB1184f7C, 2453, 188, 187, 1, 0, 188, 0, 0, 1.0, 42413, ss: 128 sss: 32 
0x925e25ab67ca3964a1230260767a22e46df9b104, 2387, 177, 171, 6, 0, 177, 0, 0, 1.0, 70246, ss: 128 sss: 32 
0x44b3e901e18dd4be9de6d41b28eb7341355722bb, 1520, 107, 106, 1, 0, 107, 0, 0, 1.0, 68695, ss: 128 sss: 32 
0x437b2c7a7e022fd44d138a250b5d9617ce7dc1e3, 1235, 93, 92, 1, 0, 93, 0, 0, 1.0, 34327, ss: 128 sss: 32 
0xf365cfabd90a1f954d377d3be32e4e251dcb0d95, 1535, 116, 114, 2, 0, 116, 0, 0, 1.0, 29347, ss: 128 sss: 32 
0x2bdcd30f19a1c6199533d713d900b0949c3a8649, 1583, 108, 107, 1, 0, 108, 0, 0, 1.0, 43639, ss: 128 sss: 32 
0x03fb106265bdedef45589fa915e4a49f514c4593, 1506, 107, 106, 1, 0, 107, 0, 0, 1.0, 60509, ss: 128 sss: 32 
0xd03d297d13a83a69abaa280feb8d44da83855c6a, 1489, 103, 103, 0, 0, 103, 0, 0, 1.0, 32065, ss: 128 sss: 32 
0x7ad1d1bb709996e58def36bd81e2e4124abc6163, 1371, 108, 107, 1, 0, 108, 0, 0, 1.0, 16188, ss: 128 sss: 32 
0x1cf2931af34a175d9cd3a27e8afa5746e277338c, 709, 69, 69, 0, 0, 69, 0, 0, 1.0, 5573, ss: 128 sss: 32 
0x27094206d10fa2f4559bca21046cbd50f0f671e5, 2315, 164, 162, 2, 0, 164, 0, 0, 1.0, 57101, ss: 128 sss: 32 
0xfe65b765c518b63c792b9b97335a6e7f0bfc960c, 2452, 219, 205, 14, 0, 219, 0, 0, 1.0, 59756, ss: 128 sss: 32 
0x0666e43181a9fccd2672fd80618ac26cd769f832, 1989, 160, 155, 5, 0, 160, 0, 0, 1.0, 56303, ss: 128 sss: 32 
0x77a2059e50e75c2e5a3d9444ec07c6d2358246b6, 2415, 226, 215, 11, 0, 226, 0, 0, 1.0, 84174, ss: 128 sss: 32 
0xdf4eae6551903b2666e9cb2c85573e035d25fb13, 1510, 107, 106, 1, 0, 107, 0, 0, 1.0, 62557, ss: 128 sss: 32 
0x2699cbe5fb7a026509ec892ddfb21c39d1b190cb, 1530, 107, 106, 1, 0, 107, 0, 0, 1.0, 60038, ss: 128 sss: 32 
0x7bce3751c2a595b30f73fe0b34ad7dbea51756d6, 1840, 89, 89, 0, 0, 89, 0, 0, 1.0, 6938, ss: 128 sss: 32 
0xb498a4a72573b32bd77ea060b8487990f7c15286, 1485, 116, 115, 1, 0, 116, 0, 0, 1.0, 36353, ss: 128 sss: 32 
0x84e24271c69e1cd4574432ea2177e2d2b6ea04cd, 1508, 107, 106, 1, 0, 107, 0, 0, 1.0, 30730, ss: 128 sss: 32 
0xa061a03671a12f8e65d088bb289deb9f70511cc5, 1529, 108, 106, 2, 0, 108, 0, 0, 1.0, 61772, ss: 128 sss: 32 
0x19007450ab4b98fd248af72c842edfaedbe78e1b, 1888, 145, 144, 1, 0, 145, 0, 0, 1.0, 23243, ss: 128 sss: 32 
0x6f565d3bc1fbead0fb3521fcaa908471b24f7070, 1517, 107, 106, 1, 0, 107, 0, 0, 1.0, 55287, ss: 128 sss: 32 
0x7F75AA2274273F4d41267A0E2Cd6c9b96C5B7510, 1270, 99, 98, 1, 0, 99, 0, 0, 1.0, 26192, ss: 128 sss: 32 
0x657f2b12fbaeb8ba6920f7425bcfeaed24dc11be, 1505, 107, 106, 1, 0, 107, 0, 0, 1.0, 33216, ss: 128 sss: 32 
0x32e1bfd713d9fef8a5d1bc10592a2d0fc10b92ff, 1157, 117, 116, 1, 0, 117, 0, 0, 1.0, 6222, ss: 128 sss: 32 
0x39175f72bf936a8e0228de03a33649c9b4aa9780, 1192, 85, 84, 1, 0, 85, 0, 0, 1.0, 19801, ss: 128 sss: 32 
0xcfa1bd6f5131f4f99f1d276d2de3fe7bf224a80c, 1507, 107, 106, 1, 0, 107, 0, 0, 1.0, 56357, ss: 128 sss: 32 
0xb3bb1d731936bf83f725fce272a6d357071999fe, 1520, 107, 106, 1, 0, 107, 0, 0, 1.0, 61760, ss: 128 sss: 32 
0x0eb120655aa35a255d6db4fc8ff9456cddb56e27, 1518, 107, 106, 1, 0, 107, 0, 0, 1.0, 55740, ss: 128 sss: 32 
0x7e81f954fa4f8877d45ce4867363e9c913599746, 1605, 110, 109, 1, 0, 110, 0, 0, 1.0, 40503, ss: 128 sss: 32 
0x2cce3a267eeec5219ae66583f37876b39cb44eb9, 2321, 146, 144, 2, 0, 146, 0, 0, 1.0, 31220, ss: 128 sss: 32 
0x3b706073f3f1ad22a900e713e49180b02b99ac65, 1515, 107, 106, 1, 0, 107, 0, 0, 1.0, 54278, ss: 128 sss: 32 
0xc57def71b0ba124bad5841718e36ebcca99a3d5b, 1515, 107, 106, 1, 0, 107, 0, 0, 1.0, 56173, ss: 128 sss: 32 
0x29c927e801b3c1ddb432ddcf0b88c2c08485c7ee, 1508, 107, 106, 1, 0, 107, 0, 0, 1.0, 30663, ss: 128 sss: 32 
0xdf2c0df62d769a4f7dc364317d978c855ab7de85, 1511, 107, 106, 1, 0, 107, 0, 0, 1.0, 51632, ss: 128 sss: 32 
0xf56e52d126db022b0fe83454ce53cb6a794047ac, 1360, 96, 95, 1, 0, 96, 0, 0, 1.0, 34424, ss: 128 sss: 32 
0xd29cf5a0c1abf0600b1eeabd053c8ef700097719, 1509, 107, 106, 1, 0, 107, 0, 0, 1.0, 28938, ss: 128 sss: 32 
0xdd4f02e6cd7FE818f64e7dC279263B4400F860A9, 2606, 265, 255, 10, 0, 265, 0, 0, 1.0, 101066, ss: 128 sss: 32 
0xcd758a5e59d8e6293f8749370647bacbb5327fbb, 1537, 80, 72, 8, 0, 80, 0, 0, 1.0, 7508, ss: 128 sss: 32 
0xe171AFcd1E0394b3312e68ca823D5BC87F3Db311, 1704, 136, 131, 5, 0, 136, 0, 1, 1.0, 32840, ss: 128 sss: 32 
0x78791ee453093a33486a7a5c5e425f998f63a785, 1199, 85, 84, 1, 0, 85, 0, 0, 1.0, 12206, ss: 128 sss: 32 
0x73c5e9a1424bf7a1731cbb278d00507246d22928, 2443, 218, 198, 20, 0, 218, 0, 0, 1.0, 63392, ss: 128 sss: 32 
0xc3a9f3fac246701b0f620ddea6078a0b623fb3a0, 1530, 107, 106, 1, 0, 107, 0, 0, 1.0, 62551, ss: 128 sss: 32 
0xc9477d2c6bfd555ece7b481554277c8496e2ddb6, 2009, 144, 142, 2, 0, 144, 0, 0, 1.0, 44124, ss: 128 sss: 32 
0x8d5bb759d4bc70aadd17c4f0d9e5f94731ab2252, 2254, 151, 147, 4, 0, 151, 0, 0, 1.0, 84465, ss: 128 sss: 32 
0x72A3a1461A88E2785b0Fb19AcE6C6137502b3622, 2231, 170, 159, 11, 0, 170, 0, 0, 1.0, 27003, ss: 128 sss: 32 
0x7494608b50d6f673e5114655b21e8299e68d5a47, 1235, 93, 92, 1, 0, 93, 0, 0, 1.0, 13284, ss: 128 sss: 32 
0x683c8e87e74f3f8f27c0d2ebd4350fe4dba814ef, 1208, 105, 103, 2, 0, 105, 0, 1, 1.0, 28160, ss: 128 sss: 32 
0xc7b10907033Ca6e2FC00FCbb8CDD5cD89f141384, 2069, 172, 170, 2, 0, 172, 0, 0, 1.0, 44421, ss: 128 sss: 32 
0xc70150188142fbfcbb90db05bffc31bccded3da5, 67, 2, 2, 0, 0, 2, 0, 0, 1.0, 6, ss: 128 sss: 32 
0x1fd1b29b8e7e652dcd0ab9867482ed9d71efab87, 1326, 92, 92, 0, 0, 92, 0, 0, 1.0, 24649, ss: 128 sss: 32 
0x3fd78dc101ef657575a11aa70ea563fc1c9c30e5, 1607, 110, 109, 1, 0, 110, 0, 0, 1.0, 42045, ss: 128 sss: 32 
0xa151e7a30b805d399106bef9ee6b4a463232b643, 1517, 107, 106, 1, 0, 107, 0, 0, 1.0, 34883, ss: 128 sss: 32 
0x86b130298719F753808E96cA6540b684a2d21466, 72, 1, 1, 0, 0, 1, 0, 0, 1.0, 14, ss: 128 sss: 32 
0x62fb2cdaf98b4851920548e991e14445721ad952, 1486, 103, 103, 0, 0, 103, 0, 0, 1.0, 38896, ss: 128 sss: 32 
0x88f1e52196011ed40694360cf1c82fcb7450b26f, 1508, 107, 106, 1, 0, 107, 0, 0, 1.0, 63438, ss: 128 sss: 32 
0x771b3211159ae50a12264d77256b476d0efadbe6, 2432, 226, 215, 11, 0, 226, 0, 0, 1.0, 85104, ss: 128 sss: 32 
0xb4066ded5bab002ca19fb49a2335926ae00e7b46, 1583, 108, 108, 0, 0, 108, 0, 0, 1.0, 54891, ss: 128 sss: 32 
0x3abcbebb79589480d4db318254fa2593fca3c14e, 2440, 217, 197, 20, 0, 217, 0, 0, 1.0, 51773, ss: 128 sss: 32 
0xc1749c8eae1af9c3ea21816743ab406e238d0f90, 1507, 107, 106, 1, 0, 107, 0, 0, 1.0, 69489, ss: 128 sss: 32 
0x09d1341849319F46A1feF75575C3bDa339649295, 1806, 125, 120, 5, 0, 125, 0, 0, 1.0, 8354, ss: 128 sss: 32 
0x90a991b36d8a5cf0acd877223470cc42688124d7, 2939, 263, 248, 15, 0, 263, 0, 0, 1.0, 79418, ss: 128 sss: 32 
0xa434c4f41cdb89713758bdfbdfbeeb6e8d74ec63, 1513, 107, 106, 1, 0, 107, 0, 0, 1.0, 44550, ss: 128 sss: 32 
0x62f2f56ade240ea712a86d7a73dd11e24ce61a51, 2674, 93, 93, 0, 0, 93, 0, 0, 1.0, 16836, ss: 128 sss: 32 
0x8a83ff75acb48feaa1644eeabf5acebd71b60c80, 750, 88, 88, 0, 0, 88, 0, 0, 1.0, 2409, ss: 128 sss: 32 
0x48b3fd97730063f317b4d03a092dcaf8f49e8f70, 1824, 89, 89, 0, 0, 89, 0, 0, 1.0, 5909, ss: 128 sss: 32 
0x9a830f33d4ccc4c8a003f4c6afb246c6a9efa96b, 2391, 166, 161, 5, 0, 166, 0, 0, 1.0, 92919, ss: 128 sss: 32 
0x71e454a66Df5c67a0C5AB61fc3c60953B6aeb67a, 1317, 87, 87, 0, 0, 87, 0, 0, 1.0, 25334, ss: 128 sss: 32 
0xc3c5fcaba66db9db08b819c5d01ff9490f59c74d, 1374, 99, 98, 1, 0, 99, 0, 0, 1.0, 24182, ss: 128 sss: 32 
0x31d8e8b5cea7c8d38e845ba450f7b114cc41c0f8, 1558, 108, 107, 1, 0, 108, 0, 0, 1.0, 37955, ss: 128 sss: 32 
0x6cb5096af3a3080a415bd714d512f88556567cf4, 1516, 107, 106, 1, 0, 107, 0, 0, 1.0, 30677, ss: 128 sss: 32 
0x6b4877874d1f0c17ebd75d7fd261e1563174136e, 1513, 107, 106, 1, 0, 107, 0, 0, 1.0, 30786, ss: 128 sss: 32 
0x2043e1d61b2aaec7a380b187d373b77aa612904b, 2138, 195, 183, 12, 0, 195, 0, 0, 1.0, 78978, ss: 128 sss: 32 
0xe95e4f6A61a8acf0EB779B29056458DFA8Dcc733, 2840, 245, 228, 17, 0, 245, 0, 0, 1.0, 128756, ss: 128 sss: 32 
0xad98414815ef406da4631c9804ccfbedd3225035, 1028, 107, 107, 0, 0, 107, 0, 0, 1.0, 22837, ss: 128 sss: 32 
0x66251a68d34fffc0fe2d78bae90a8e5311859a0e, 1511, 108, 106, 2, 0, 108, 0, 0, 1.0, 52582, ss: 128 sss: 32 
0xb3d1E37784c884c197fB4a94D23b669620cae4c6, 2281, 215, 202, 13, 0, 215, 0, 0, 1.0, 21311, ss: 128 sss: 32 
0x0ae84bdf27b002197a747ad24d9ac4c2e004e6da, 2433, 217, 197, 20, 0, 217, 0, 0, 1.0, 34159, ss: 128 sss: 32 
0xa780801815E8384794278d02214cfCe645f4d1Ae, 70, 5, 5, 0, 0, 5, 0, 0, 1.0, 9, ss: 128 sss: 32 
0x25a919D38c5D395FCb1f9d9e8895B68C53F39fdC, 456, 38, 38, 0, 0, 38, 0, 0, 1.0, 126, ss: 128 sss: 32 
0x39be7ba92f5857256dbb9873c200e41d44ab3a27, 1511, 107, 106, 1, 0, 107, 0, 0, 1.0, 62689, ss: 128 sss: 32 
0x88484cba4988dcc2921829923212081bd696cece, 1999, 158, 145, 13, 0, 158, 0, 0, 1.0, 50818, ss: 128 sss: 32 
0xdc2afdbf00f4bdb31d6c1e8b0b7588305f5847cd, 1587, 107, 107, 0, 0, 107, 0, 0, 1.0, 28853, ss: 128 sss: 32 
0xF693e9aa1F99e8A33F947D9E3b3E1C20313D1B9d, 2375, 220, 205, 15, 0, 220, 0, 0, 1.0, 78304, ss: 128 sss: 32 
0x91616468237b7ee834e7d1b91f92551126021157, 1770, 140, 137, 3, 0, 140, 0, 0, 1.0, 38005, ss: 128 sss: 32 
0x3132a842709ced15c548359a7aae92f0699cc095, 1570, 108, 107, 1, 0, 108, 0, 0, 1.0, 24110, ss: 128 sss: 32 
0x85b3f8f2a80c2053c24fc7a9393e0f7dd49c208d, 1522, 107, 106, 1, 0, 107, 0, 0, 1.0, 43255, ss: 128 sss: 32 
0x772f0a1a17030cf4d2455dd5ab24b99a806b1c21, 1532, 107, 106, 1, 0, 107, 0, 0, 1.0, 33038, ss: 128 sss: 32 
0xe7d81b34a50f75c25694d4619508c142c9e37a03, 2743, 262, 239, 23, 0, 262, 0, 0, 1.0, 82798, ss: 128 sss: 32 
0x41f3a6544f65ee161bf383821d8f095687afe284, 1524, 107, 106, 1, 0, 107, 0, 0, 1.0, 43679, ss: 128 sss: 32 
0xfaf000C2d33C1Cf357bf6F2d61B18Af0b76F90E8, 2325, 205, 195, 10, 0, 205, 0, 0, 1.0, 48700, ss: 128 sss: 32 
0xB394eC56AbD78c9264438168F8a8E1Bd85F1f0Ae, 2575, 256, 248, 8, 0, 256, 0, 0, 1.0, 126261, ss: 128 sss: 32 
0x8d3e1386781a0f4dca28bbc890780ba88a87f87c, 1528, 115, 113, 2, 0, 115, 0, 0, 1.0, 19851, ss: 128 sss: 32 
0x6a8d47c46E28DB7637190C0A8f50C15F8047A094, 2162, 175, 173, 2, 0, 175, 0, 0, 1.0, 24090, ss: 128 sss: 32 
0xd3DE54d9e424BF27b8259E69B205127722c771Cb, 562, 44, 44, 0, 0, 44, 0, 0, 1.0, 359, ss: 128 sss: 32 
0x03a6059a5427fc6a4784baea42ac8b7228b4cda2, 1928, 173, 165, 8, 0, 173, 0, 0, 1.0, 65794, ss: 128 sss: 32 
0x955ee8d7f7756d88bba9877ce43247a3d0bcac36, 1530, 108, 106, 2, 0, 108, 0, 0, 1.0, 53282, ss: 128 sss: 32 
0x81afbd4f78e5a144fc11864e387672a0fac6b49f, 1518, 107, 106, 1, 0, 107, 0, 0, 1.0, 29243, ss: 128 sss: 32 
0x52B35406CB2FB5e0038EdEcFc129A152a1f74087, 1704, 136, 131, 5, 0, 136, 0, 1, 1.0, 51176, ss: 128 sss: 32 
0x864c7404d09e77cb43fd7c1888f94d3c35a1ff27, 1427, 101, 100, 1, 0, 101, 0, 0, 1.0, 43573, ss: 128 sss: 32 
0x48ff5026071d177906508d4fedc33871fbbba59d, 1648, 114, 112, 2, 0, 114, 0, 0, 1.0, 21387, ss: 128 sss: 32 
0xa3Bb3866A0082bcDe11A081b7240B5c828c994f2, 2239, 166, 156, 10, 0, 166, 0, 0, 1.0, 18892, ss: 128 sss: 32 
0x7d3e4ad388f7f9cfcb6ae58a63777ef6fe076379, 2583, 185, 182, 3, 0, 185, 0, 0, 1.0, 43537, ss: 128 sss: 32 
0xf0401ba27351fcba95aa8efc84582e5e7d8e489b, 1506, 107, 106, 1, 0, 107, 0, 0, 1.0, 61179, ss: 128 sss: 32 
0x7db975750660de45d73ca1fed00b35a8dfd784df, 1514, 107, 106, 1, 0, 107, 0, 0, 1.0, 67643, ss: 128 sss: 32 
0xe2074c4a5772a650fb47cb97a182b87fa4ccc793, 1815, 131, 129, 2, 0, 131, 0, 0, 1.0, 35586, ss: 128 sss: 32 
0x73c9f5d63199f594aefa0b495b0cca69f0fe6a3a, 2862, 263, 245, 18, 0, 263, 0, 0, 1.0, 96906, ss: 128 sss: 32 
0x2A078B1EcCAC2f4BFA1858E611EA360206dcE39c, 1759, 127, 121, 6, 0, 127, 0, 0, 1.0, 31736, ss: 128 sss: 32 
0xfcad7faeb334462a5541bc6959197c1d3cd2e2e5, 2124, 197, 175, 22, 0, 197, 0, 0, 1.0, 35226, ss: 128 sss: 32 
0x201c00ba25cAc8e8FC23F001B1b6095094998c31, 1380, 107, 103, 4, 0, 107, 0, 0, 1.0, 60, ss: 128 sss: 32 
0xfACd6F2f378b5e082a8Ab7B6a9765f79c3743d77, 1902, 171, 159, 12, 0, 171, 0, 0, 1.0, 44049, ss: 128 sss: 32 
0x8856c37965283bdd00c9c98e12bd63c673126c1a, 2610, 185, 177, 8, 0, 185, 0, 0, 1.0, 54662, ss: 128 sss: 32 
0x57f63ef099876ed555f5b7fe6f76392e1502eb19, 1895, 147, 147, 0, 0, 147, 0, 0, 1.0, 20510, ss: 128 sss: 32 
0x34504644b56cbe86b34f39e679c435d435f18747, 2048, 151, 150, 1, 0, 151, 0, 0, 1.0, 73706, ss: 128 sss: 32 
0x5a478bd4f6bf1798a1593d22a8e53bf67ab099da, 1923, 173, 165, 8, 0, 173, 0, 0, 1.0, 57300, ss: 128 sss: 32 
0x4201280fd3e1831fb83e539867150628d23206aa, 2659, 238, 213, 25, 0, 238, 0, 0, 1.0, 44444, ss: 128 sss: 32 
0x18dcb0f9ce032ec85a17ae3e3a2f120999ccabe5, 1521, 107, 106, 1, 0, 107, 0, 0, 1.0, 31691, ss: 128 sss: 32 
0x9b155f4a3f26282ab75da2103a4c95443f1fc899, 1510, 107, 106, 1, 0, 107, 0, 0, 1.0, 40688, ss: 128 sss: 32 
0x73A15FeD60Bf67631dC6cd7Bc5B6e8da8190aCF5, 730, 52, 48, 4, 0, 52, 0, 0, 1.0, 303, ss: 128 sss: 32 
0x83d23bccc19449a2f66de54ef4903535be284a09, 1822, 89, 89, 0, 0, 89, 0, 0, 1.0, 2148, ss: 128 sss: 32 
0xe44c3f63fd25c2b1b9a04d1a876e9b6438f2b442, 1574, 107, 106, 1, 0, 107, 0, 0, 1.0, 34704, ss: 128 sss: 32 
0xdfde17c02795da1b5fb1b59abdbe175eb0eace43, 1534, 116, 114, 2, 0, 116, 0, 0, 1.0, 36022, ss: 128 sss: 32 
0x4c5e43fa403eda7aa1496d9e6ebe60a23ceadbff, 2312, 188, 177, 11, 0, 188, 0, 0, 1.0, 38416, ss: 128 sss: 32 
0x11ba98790ae84fd6c69affbae3684bf9c80fe258, 1511, 107, 106, 1, 0, 107, 0, 0, 1.0, 36117, ss: 128 sss: 32 
0x0b03ff98663fa7b97edc1b305e66ebf193b1d9cc, 1573, 103, 103, 0, 0, 103, 0, 0, 1.0, 26465, ss: 128 sss: 32 
0x89caf22b1c2a7daf811e89c523f01e8f1bf032d6, 1618, 115, 114, 1, 0, 115, 0, 0, 1.0, 35934, ss: 128 sss: 32 
0xd215c87988c46c71a0532058ddff01c885eb015c, 1226, 87, 87, 0, 0, 87, 0, 0, 1.0, 7583, ss: 128 sss: 32 
0xEBb2ecdae91F875D4f25f26D1494bba0c52a04bC, 1716, 155, 155, 0, 0, 155, 0, 0, 1.0, 34586, ss: 128 sss: 32 
0xa48ea9c7e91caeeafc6b134f014e0f168d8042ef, 1513, 107, 106, 1, 0, 107, 0, 0, 1.0, 37553, ss: 128 sss: 32 
0x95cdbe5228a77b5933b6f3a2f660bf2e3a1e1985, 1516, 107, 106, 1, 0, 107, 0, 0, 1.0, 47062, ss: 128 sss: 32 
0x891459b56cd7f82993a0f272f4979695db2a66e5, 1517, 127, 127, 0, 0, 127, 0, 0, 1.0, 37069, ss: 128 sss: 32 
0x2b7269406785b8e33a79d99fc510ed378bf0069b, 2346, 162, 158, 4, 0, 162, 0, 0, 1.0, 53188, ss: 128 sss: 32 
0x4306a742e7b7f6d05dc70a3461a4df2352e9b995, 1876, 185, 181, 4, 0, 185, 0, 0, 1.0, 253642, ss: 128 sss: 32 
0x48abd6e35e8ff3b61959cb269adf88bfcb66572b, 1622, 115, 114, 1, 0, 115, 0, 0, 1.0, 50461, ss: 128 sss: 32 
0x7d26f3c13c606d420c31b7df8447c3e1e35af06a, 1870, 156, 148, 8, 0, 156, 0, 0, 1.0, 27960, ss: 128 sss: 32 
0x2648d01013680da7e42eb22da58a845572c07560, 1511, 107, 106, 1, 0, 107, 0, 0, 1.0, 50135, ss: 128 sss: 32 
0x4c5e3e1c5977f7e427867669af78d12639006b1d, 1569, 128, 120, 8, 0, 128, 0, 1, 1.0, 27720, ss: 128 sss: 32 
0x3E4110cd48b104DE8F1265BfadbF7c0bfd942760, 2946, 275, 262, 13, 0, 275, 0, 0, 1.0, 101764, ss: 128 sss: 32 
0x1e2f66272d44ae720dffa8991c9694c1e4fa2d63, 1012, 84, 81, 3, 0, 84, 0, 0, 1.0, 33919, ss: 128 sss: 32 
0x0c8e5c1f5c5e986d5e480c259d9dbccc4cda8765, 2571, 195, 194, 1, 0, 195, 0, 1, 1.0, 107809, ss: 128 sss: 32 
0x651c6cc4ebbe421319bae4eadf4fa769ff14bf3e, 1590, 110, 110, 0, 0, 110, 0, 0, 1.0, 49780, ss: 128 sss: 32 
0x0DF1B286F20c29BC9F61BcC98c5D42D0404DBd07, 2946, 275, 262, 13, 0, 275, 0, 0, 1.0, 64638, ss: 128 sss: 32 
0x838a72e1dc465e110409a879e0ac73c6292ed494, 1539, 107, 106, 1, 0, 107, 0, 0, 1.0, 51362, ss: 128 sss: 32 
0x55648Ddd02a912058ccd5d173ae42F779a141a54, 1187, 119, 102, 17, 0, 119, 0, 0, 1.0, 4368, ss: 128 sss: 32 
0x6849bc47e2c815e16d765c9500e1cd841f22b282, 1607, 110, 109, 1, 0, 110, 0, 0, 1.0, 20026, ss: 128 sss: 32 
0x6d01ab042519c395b435d71cac77cc2f93287d19, 2978, 231, 222, 9, 0, 231, 0, 0, 1.0, 74987, ss: 128 sss: 32 
0xbe01Af16910183a72c332681FE239a91999aD670, 600, 38, 38, 0, 0, 38, 0, 0, 1.0, 5070, ss: 128 sss: 32 
0x0aa40906800717C71c62Df911b186817F542763D, 2928, 273, 256, 17, 0, 273, 0, 0, 1.0, 128460, ss: 128 sss: 32 
0x98f98254a276f5c15d1d21f583e9bf67bb6af9c2, 1236, 93, 92, 1, 0, 93, 0, 0, 1.0, 29174, ss: 128 sss: 32 
0x51ffbe483e44f0eec54afac7f7051d62012b18fb, 1524, 107, 106, 1, 0, 107, 0, 0, 1.0, 29223, ss: 128 sss: 32 
0xb71b367e4d4a610d7339b216339bb77d7414075a, 1531, 107, 106, 1, 0, 107, 0, 0, 1.0, 39175, ss: 128 sss: 32 
0x19cf8dc98772ffa09ff23e04d6053c97729c077a, 2418, 226, 215, 11, 0, 226, 0, 0, 1.0, 73271, ss: 128 sss: 32 
0x079e29de1a55867d6236b384b865b7a5ec5f08c8, 1614, 114, 113, 1, 0, 114, 0, 0, 1.0, 68484, ss: 128 sss: 32 
0xd2c59781f1db84080a0592ce83fe265642a4a8eb, 233, 15, 15, 0, 0, 15, 0, 0, 1.0, 77, ss: 128 sss: 32 
0x1a5c1609fc86296df06535b8c670633ee0ad55af, 1513, 107, 106, 1, 0, 107, 0, 0, 1.0, 47730, ss: 128 sss: 32 
0x358f4decfda82c20c6bd274bde087613c48a1c75, 2830, 245, 227, 18, 0, 245, 0, 0, 1.0, 99108, ss: 128 sss: 32 
0xe824ee9cecd266c368f2e02bffd3c3821e6f88e1, 1528, 108, 106, 2, 0, 108, 0, 0, 1.0, 40625, ss: 128 sss: 32 
0x147aae07dF268817994FD674a4f69D493c283e24, 2211, 163, 153, 10, 0, 163, 0, 0, 1.0, 24936, ss: 128 sss: 32 
0x5db6e8e85f635391a3bfa5e93126947af20ad05f, 1553, 103, 103, 0, 0, 103, 0, 0, 1.0, 21383, ss: 128 sss: 32 
0x825d7ff688d4288ddebf57b66104474afb2e50f8, 2259, 151, 147, 4, 0, 151, 0, 0, 1.0, 94034, ss: 128 sss: 32 
0x1a5b13ef713ba23f7bb17013d1c73797e1285f26, 2651, 191, 191, 0, 0, 191, 0, 0, 1.0, 57797, ss: 128 sss: 32 
0xbfdeaec095dbb1df61356500febd70ab516575a9, 1525, 107, 106, 1, 0, 107, 0, 0, 1.0, 50461, ss: 128 sss: 32 
0x752446c704ba6e9d261eb810a20f3f1514623e18, 1010, 84, 81, 3, 0, 84, 0, 0, 1.0, 33213, ss: 128 sss: 32 
0x04efd93916490d95cbbc1e63484430af8db7fced, 1510, 107, 106, 1, 0, 107, 0, 0, 1.0, 35156, ss: 128 sss: 32 
0x50319ceA7d046b1EF0F1379473d80dA883eCD6b3, 2702, 206, 203, 3, 0, 206, 0, 0, 1.0, 45337, ss: 128 sss: 32 
0xf6Bd46bdc1153CE0b934EdCD3F42Af597375BeCE, 1828, 130, 127, 3, 0, 130, 0, 0, 1.0, 16284, ss: 128 sss: 32 
0xe4bb489733d577545eee6935dbacd5db230cd5f9, 1520, 107, 106, 1, 0, 107, 0, 0, 1.0, 72088, ss: 128 sss: 32 
0x55a51a884aad46425743d64873024d6002c8cee4, 1504, 109, 109, 0, 0, 109, 0, 0, 1.0, 26482, ss: 128 sss: 32 
0xe591293151fFDadD5E06487087D9b0E2743de92E, 1123, 99, 97, 2, 0, 99, 0, 1, 1.0, 56795, ss: 128 sss: 32 
0x2604a868be5d7e1e0d88d08507fe717376c9eff9, 1258, 68, 62, 6, 0, 68, 0, 0, 1.0, 979, ss: 128 sss: 32 
0xbffaf03f35d75417091f0f42de3ec6809ffa51eb, 1910, 171, 159, 12, 0, 171, 0, 0, 1.0, 40584, ss: 128 sss: 32 
0x8ab8e01c5f96af1546a8d0b1df2107bdd5293bb4, 1489, 103, 103, 0, 0, 103, 0, 0, 1.0, 55743, ss: 128 sss: 32 
0xf942ae9cfb58cd8e4a9dbca3127aac9b9d127a4c, 2564, 182, 175, 7, 0, 182, 0, 0, 1.0, 32981, ss: 128 sss: 32 
0x25bb3d2f8db0776e68beb2b2ede7d6b229f374b7, 1602, 110, 109, 1, 0, 110, 0, 0, 1.0, 33531, ss: 128 sss: 32 
0x456415994faa57ea23c94c91f932d6f9d4e4cd2d, 1521, 107, 106, 1, 0, 107, 0, 0, 1.0, 35333, ss: 128 sss: 32 
0x302be214b4fae9e998d3285f61335cd4e6feda9c, 1504, 107, 106, 1, 0, 107, 0, 0, 1.0, 59713, ss: 128 sss: 32 
0x361768d1cf41aa232eb6436d477505f446ee65b6, 1588, 108, 108, 0, 0, 108, 0, 0, 1.0, 55318, ss: 128 sss: 32 
0x6308ecf2ae87415380172cd838693ec02d2c01cd, 2658, 189, 182, 7, 0, 189, 0, 0, 1.0, 89191, ss: 128 sss: 32 
0xe3b07168cf4e33f1ba1bb8bacb801416aa21886b, 1604, 110, 109, 1, 0, 110, 0, 0, 1.0, 27218, ss: 128 sss: 32 
0x750c08afe6468fb83986e5b5b222273fb925f881, 1171, 98, 95, 3, 0, 98, 0, 0, 1.0, 8888, ss: 128 sss: 32 
0x67dc13caa15fac1630906b0764171fa4c0cf4f86, 1498, 110, 109, 1, 0, 110, 0, 0, 1.0, 32331, ss: 128 sss: 32 
0xabdbb362316288fdd320d55a6490ab0fc04427bc, 1812, 131, 129, 2, 0, 131, 0, 0, 1.0, 39307, ss: 128 sss: 32 
0x6F7d9dBc517B8A64818554970443b0D08340dc95, 2956, 275, 262, 13, 0, 275, 0, 0, 1.0, 71602, ss: 128 sss: 32 
0x4c97be4f881c68acb00d9fa33cac4a4a237439a1, 1521, 107, 106, 1, 0, 107, 0, 0, 1.0, 62428, ss: 128 sss: 32 
0xc5a52cdc14b69085ec330499458a848f2dca20f3, 1508, 107, 106, 1, 0, 107, 0, 0, 1.0, 58698, ss: 128 sss: 32 
0x609ce00aec360ddc7380d920d0abf29a2f4bfe0a, 1515, 107, 106, 1, 0, 107, 0, 0, 1.0, 70185, ss: 128 sss: 32 
0xf9826560f7bf6d76e042144397477772b293600d, 1891, 145, 144, 1, 0, 145, 0, 0, 1.0, 22756, ss: 128 sss: 32 
0x8a915282bab9985ea4c13ad35b53403644ebeace, 1328, 92, 92, 0, 0, 92, 0, 0, 1.0, 35004, ss: 128 sss: 32 
0xff20148570eb28b01ee608e940ba07d92e39081b, 2255, 151, 147, 4, 0, 151, 0, 0, 1.0, 38386, ss: 128 sss: 32 
0xce7a46f5255ddf16dbb9ed626e9015318ef0e3d8, 2164, 197, 189, 8, 0, 197, 0, 0, 1.0, 74541, ss: 128 sss: 32 
0xd6e3f490b0d9cd7f79a13dce6f4d2504ef92852d, 1504, 107, 106, 1, 0, 107, 0, 0, 1.0, 34341, ss: 128 sss: 32 
0xe76a7cd241764ffd57e10b24619ac7d8e156c5df, 1516, 107, 106, 1, 0, 107, 0, 0, 1.0, 35190, ss: 128 sss: 32 
0xc44e905ce304bf8fa5511f75d18a35b664fc9432, 1524, 107, 106, 1, 0, 107, 0, 0, 1.0, 66658, ss: 128 sss: 32 
0x19239be618962288ebef875322d2c13a51cc6469, 2207, 210, 196, 14, 0, 210, 0, 1, 1.0, 46219, ss: 128 sss: 32 
0x9EB0f9702e9bd1D478B4F027120CB5659cc999b8, 2228, 178, 168, 10, 0, 178, 0, 0, 1.0, 21563, ss: 128 sss: 32 
0xf476b7fd0002487ee1ab4f44eea1b81b93dabcf0, 1520, 107, 106, 1, 0, 107, 0, 0, 1.0, 62115, ss: 128 sss: 32 
0xb1d6aa04c7a4222fcf211406beeea362b3851d9f, 1507, 107, 106, 1, 0, 107, 0, 0, 1.0, 31992, ss: 128 sss: 32 
0xccddc53e04e6a46a4efb970acd2f1b79faf51187, 1620, 115, 113, 2, 0, 115, 0, 0, 1.0, 29628, ss: 128 sss: 32 
0xfbbda7e8bdd468ead6b51f19427c435cbd459c3c, 370, 31, 31, 0, 0, 31, 0, 0, 1.0, 3627, ss: 128 sss: 32 
0x16a70939d9aeb729adc8da34b9ed63538a603c42, 1591, 110, 109, 1, 0, 110, 0, 0, 1.0, 20841, ss: 128 sss: 32 
0xa134f4c20cf6b5ab5e357443057cf5f02db994c0, 1511, 107, 106, 1, 0, 107, 0, 0, 1.0, 53267, ss: 128 sss: 32 
0xb8C9b6E10B1D2103745B91d703F219bEB72F1FEF, 2956, 275, 262, 13, 0, 275, 0, 0, 1.0, 76417, ss: 128 sss: 32 
0x175ac16e9703b96721fd6ee785defff9c892eeca, 2588, 184, 178, 6, 0, 184, 0, 0, 1.0, 58427, ss: 128 sss: 32 
0x0a0c60c94769d675081b2a3f78acbf47c776d974, 2818, 290, 261, 29, 0, 290, 0, 0, 1.0, 48959, ss: 128 sss: 32 
0xbe18c8167b9678909a1d31f3ba7a84a732026872, 1618, 115, 114, 1, 0, 115, 0, 0, 1.0, 28777, ss: 128 sss: 32 
0xb97e163cE6A8296F36112b042891CFe1E23C35BF, 730, 52, 48, 4, 0, 52, 0, 0, 1.0, 369, ss: 128 sss: 32 
0x465d83a3bd174b4eb27fa39e3186a641e5a61ff8, 1510, 107, 106, 1, 0, 107, 0, 0, 1.0, 68697, ss: 128 sss: 32 
0x74089e73a22e86a4be57043b9819f7b9c9793667, 1511, 107, 106, 1, 0, 107, 0, 0, 1.0, 39430, ss: 128 sss: 32 
0x77a45fa1e6b6e6557c8aca6de2a4eb5557bc5881, 1586, 108, 108, 0, 0, 108, 0, 0, 1.0, 27828, ss: 128 sss: 32 
0x2f043b3077e591f41dba11661c76c360347e1805, 1505, 107, 106, 1, 0, 107, 0, 0, 1.0, 66879, ss: 128 sss: 32 
0x5c9d8b9ef888ae4cd45a867b8cd61cd094d302f0, 1423, 101, 100, 1, 0, 101, 0, 0, 1.0, 28388, ss: 128 sss: 32 
0x4a9e4e00564fa0c7a0de71976b8072d8b0f702d5, 1811, 145, 140, 5, 0, 145, 0, 1, 1.0, 29137, ss: 128 sss: 32 
0xfeb669045652b62cEF47ecFd286d39e4730f51b3, 1315, 87, 87, 0, 0, 87, 0, 0, 1.0, 61396, ss: 128 sss: 32 
0x6aea5a7ce50fb7d6dd362bf34080adf08c9c4956, 1512, 107, 106, 1, 0, 107, 0, 0, 1.0, 42465, ss: 128 sss: 32 
0x7e49f1bd734c096c7a33e204522bb2d5060a91a8, 1520, 107, 106, 1, 0, 107, 0, 0, 1.0, 31509, ss: 128 sss: 32 
0xde6e1F680C4816446C8D515989E2358636A38b04, 730, 52, 48, 4, 0, 52, 0, 0, 1.0, 332, ss: 128 sss: 32 
0x42BcCB90eCCDAe96F6435C82eEfdD2DA577659fc, 1903, 144, 130, 14, 0, 144, 0, 0, 1.0, 2697, ss: 128 sss: 32 
0xfb4e98a54710e1305043257e7c44c3cc67b0da3a, 1756, 124, 124, 0, 0, 124, 0, 0, 1.0, 35111, ss: 128 sss: 32 
0x69053ecdAfD06CF8813682Ee7F3ce807B3568118, 2845, 245, 228, 17, 0, 245, 0, 0, 1.0, 88216, ss: 128 sss: 32 
0x10ac3f60f0111e812f3274a1a51075be26ee39a1, 172, 11, 10, 1, 0, 11, 0, 0, 1.0, 61, ss: 128 sss: 32 
0xd5A8004Afd44A83e913f325f9b3C656977453704, 171, 8, 6, 2, 0, 8, 0, 0, 1.0, 19, ss: 128 sss: 32 
0x04fabe1de8d972d3c4ce53d2dad8b73b86da8788, 1967, 184, 170, 14, 0, 184, 0, 0, 1.0, 46711, ss: 128 sss: 32 
0xdfdec0d573ba50214911079c4283020e72ff7f92, 1512, 107, 106, 1, 0, 107, 0, 0, 1.0, 58033, ss: 128 sss: 32 
0x0a024eccfd9fb1de9b6a526ce5e65ce6ebb39500, 2840, 245, 228, 17, 0, 245, 0, 0, 1.0, 55599, ss: 128 sss: 32 
0x979c449d77bb27c60d1df21616514a242d89f087, 1506, 107, 106, 1, 0, 107, 0, 0, 1.0, 57885, ss: 128 sss: 32 
0xce254c058294b26ed2ed74f5d6f32d2cc0eb305d, 1591, 110, 110, 0, 0, 110, 0, 0, 1.0, 40888, ss: 128 sss: 32 
0xb850e6a3349d6f0de9647b5c3debf32fd0b92dc6, 2945, 275, 262, 13, 0, 275, 0, 0, 1.0, 78732, ss: 128 sss: 32 
0x06395888477c823f54e727c20c8ec89d4a82fbf5, 1519, 115, 114, 1, 0, 115, 0, 0, 1.0, 27936, ss: 128 sss: 32 
0x67ced5df66a3635c6dc21de92fd0dba78703bbfe, 1538, 101, 100, 1, 0, 101, 0, 0, 1.0, 46926, ss: 128 sss: 32 
0x334bf61aeb7bdd887364988609d1fc57b823ac51, 1510, 107, 106, 1, 0, 107, 0, 0, 1.0, 36594, ss: 128 sss: 32 
0xe2bb9057081fbed2885c8657e870e510695415bd, 1536, 107, 106, 1, 0, 107, 0, 0, 1.0, 35746, ss: 128 sss: 32 
0x47cd2f9a0ca6ffc368aeaf1f5c857cadf9611b4f, 1519, 108, 106, 2, 0, 108, 0, 0, 1.0, 51365, ss: 128 sss: 32 
0xc71a72df4f9314753582d506682c832aeeaa1899, 2358, 163, 159, 4, 0, 163, 0, 0, 1.0, 84684, ss: 128 sss: 32 
0xe53f524fdb3929768e0371b2e7f6de25d99c8d86, 1397, 99, 98, 1, 0, 99, 0, 0, 1.0, 18625, ss: 128 sss: 32 
0x1920cd993650b1b51162842b2569b59a09891cf5, 1910, 172, 159, 13, 0, 172, 0, 0, 1.0, 58961, ss: 128 sss: 32 
0xbcf08597eceb2bcf012480e15d9c04f3861fbe89, 1923, 147, 147, 0, 0, 147, 0, 0, 1.0, 46353, ss: 128 sss: 32 
0x32c4138e836613fe77c5e1f4dcfe816f714083a3, 2330, 203, 190, 13, 0, 203, 0, 0, 1.0, 45793, ss: 128 sss: 32 
0x390dD930a4D00Cb7b0D2CB19745B6C0Cfb0e3B73, 165, 16, 16, 0, 0, 16, 0, 0, 1.0, 90, ss: 128 sss: 32 
0x525574c899a7c877a11865339e57376092168258, 2465, 177, 168, 9, 0, 177, 0, 0, 1.0, 26623, ss: 128 sss: 32 
0xe6ad61f76209b9a15072f8cc26d7652e2687d7c0, 1211, 87, 87, 0, 0, 87, 0, 0, 1.0, 14903, ss: 128 sss: 32 
0xcF94343ec07DD2aFfb5ED3126C6d495464026C73, 2958, 275, 262, 13, 0, 275, 0, 0, 1.0, 93942, ss: 128 sss: 32 
0xaAE0DBF0eebdB2D22587BeEE04732a4c7945F270, 2581, 197, 188, 9, 0, 197, 0, 0, 1.0, 30815, ss: 128 sss: 32 
0x8bf19c12144421686a80a71e430c0c5db3705155, 1575, 111, 110, 1, 0, 111, 0, 0, 1.0, 19061, ss: 128 sss: 32 
0x40e8cb1d4287dd6efc7eb9aa8c57061e98a1afa7, 1522, 108, 106, 2, 0, 108, 0, 0, 1.0, 39288, ss: 128 sss: 32 
0x7b7505c17998d1810008e2dc315f21f0d58c3195, 1366, 96, 95, 1, 0, 96, 0, 0, 1.0, 41729, ss: 128 sss: 32 
0x7c21c4bbd63d05fa9f788e38d14e18fc52e9557b, 361, 45, 44, 1, 0, 45, 0, 0, 1.0, 432, ss: 128 sss: 32 
0xe529d447ca1a2b47120996d006c123a710875393, 2135, 195, 183, 12, 0, 195, 0, 0, 1.0, 46109, ss: 128 sss: 32 
0xC0A152d0c78D335257F4cCd474213a702096d911, 1775, 146, 136, 10, 0, 146, 0, 1, 1.0, 5578, ss: 128 sss: 32 
0x14abed2dd5fb0390a98653e9079059cf19c1f4c2, 1384, 110, 110, 0, 0, 110, 0, 0, 1.0, 27984, ss: 128 sss: 32 
0x51140947C93c35557D5d595f725Af56818b5be73, 1907, 172, 159, 13, 0, 172, 0, 0, 1.0, 66925, ss: 128 sss: 32 
0xc88f08690a4d0ba9929b0373818e071105f0420a, 2422, 226, 215, 11, 0, 226, 0, 0, 1.0, 51007, ss: 128 sss: 32 
0x4646c9F6fD80027DB95dA2Cc82038acfb5d2e688, 2968, 275, 262, 13, 0, 275, 0, 0, 1.0, 50746, ss: 128 sss: 32 
0xc125e481ae44f8af49a1a098739e4903c60ecac7, 1512, 107, 106, 1, 0, 107, 0, 0, 1.0, 54005, ss: 128 sss: 32 
0x4d5898E723b51b42320D944B9ddFb333465196d4, 179, 8, 6, 2, 0, 8, 0, 0, 1.0, 16, ss: 128 sss: 32 
0x271bf296a98604275d80afbf249d0b5054244cea, 1524, 107, 106, 1, 0, 107, 0, 0, 1.0, 45155, ss: 128 sss: 32 
0x839bca4e29e0340fc9ca841bf07abb1603a9d929, 2878, 255, 242, 13, 0, 255, 0, 0, 1.0, 32027, ss: 128 sss: 32 
0xecbdc8f6d0ab85bb1d6cceba1f568b15ff28f55e, 1504, 107, 106, 1, 0, 107, 0, 0, 1.0, 29754, ss: 128 sss: 32 
0xfDbd39f0626942d4E48FF1C1C13d51Fc3A57c52f, 1933, 172, 166, 6, 0, 172, 0, 0, 1.0, 35272, ss: 128 sss: 32 
0xfc97a0eec83017fd3b17e8eaa67850d5c2a4148a, 1512, 108, 106, 2, 0, 108, 0, 0, 1.0, 42703, ss: 128 sss: 32 
0xde8bcbfbf000442a4bc1e159af4cb80edff49abd, 1516, 107, 106, 1, 0, 107, 0, 0, 1.0, 72391, ss: 128 sss: 32 
0x059125a1e1b7b780e360caf5a5c46d0c2f6da77a, 2450, 168, 164, 4, 0, 168, 0, 0, 1.0, 63255, ss: 128 sss: 32 
0x377b319c20e77f782bafc5200a5c8d1fdb4518b2, 2853, 245, 228, 17, 0, 245, 0, 0, 1.0, 54966, ss: 128 sss: 32 
0x430e8453b0a33e0b1b092aa69f812d9227761ef2, 510, 25, 25, 0, 0, 25, 0, 0, 1.0, 108, ss: 128 sss: 32 
0x17f3e5841773cD9BDe0cBa003E462bc5ccB3125B, 2861, 247, 233, 14, 0, 247, 0, 0, 1.0, 95644, ss: 128 sss: 32 
0x5eeb8de77af38cb5db17244742989ccd128e10f6, 1080, 107, 107, 0, 0, 107, 0, 0, 1.0, 13159, ss: 128 sss: 32 
0x04bae93974f297e6871f1750f7877f24d6e99580, 2232, 184, 179, 5, 0, 184, 0, 0, 1.0, 53685, ss: 128 sss: 32 
0x09D85676cbEe4fF1A521e2b8b907Dc82F0dcDb2D, 1425, 125, 119, 6, 0, 125, 0, 0, 1.0, 37283, ss: 128 sss: 32 
0x24249f785f5b6e93e88fd2cadd70e182d8a2d657, 2177, 164, 160, 4, 0, 164, 0, 0, 1.0, 50332, ss: 128 sss: 32 
0xAE2C3256064e79D6D15DcDc505953ABaE46b23A7, 1834, 134, 132, 2, 0, 134, 0, 0, 1.0, 46874, ss: 128 sss: 32 
0x1652bebaeb95030484bb8dcf996646791e2026b5, 1509, 107, 106, 1, 0, 107, 0, 0, 1.0, 28435, ss: 128 sss: 32 
0x29dfe6138ceaf336c6662bab46fc46bb5a654f0f, 283, 16, 16, 0, 0, 16, 0, 0, 1.0, 67, ss: 128 sss: 32 
0xa4bfa98a19d8b3830cd30ba9594af06df3537dbc, 1584, 110, 110, 0, 0, 110, 0, 0, 1.0, 32386, ss: 128 sss: 32 
0x442f16202bcae63bb469949c40d7cc40e11bea8a, 1513, 107, 106, 1, 0, 107, 0, 0, 1.0, 60601, ss: 128 sss: 32 
0xcae42b353ec3f509a8f3f04c7d892030a7344bb8, 1571, 108, 107, 1, 0, 108, 0, 0, 1.0, 26711, ss: 128 sss: 32 
0xF53417f66D0A0a39fa2e6db44876Fb9413422DDB, 2547, 211, 209, 2, 0, 211, 0, 0, 1.0, 145, ss: 128 sss: 32 
0xa55c8b69748e3ca39af80edc3e7a93abcc36afae, 1602, 110, 110, 0, 0, 110, 0, 0, 1.0, 55566, ss: 128 sss: 32 
0x5e8359f5dd816a8833f990b179f179357b928a61, 1504, 107, 106, 1, 0, 107, 0, 0, 1.0, 68647, ss: 128 sss: 32 
0x165f8504dd12455f770294f0a273296ab8e446c5, 1374, 99, 98, 1, 0, 99, 0, 0, 1.0, 20474, ss: 128 sss: 32 
0x20616748570be36403dc83e3dc4cece4082f6453, 1586, 108, 108, 0, 0, 108, 0, 0, 1.0, 36031, ss: 128 sss: 32 
0xe0f53faba6cbfb022b16c9da63a1e0bad0279332, 780, 82, 81, 1, 0, 82, 0, 0, 1.0, 6655, ss: 128 sss: 32 
0x2c0687215aca7f5e2792d956e170325e92a02aca, 2013, 170, 160, 10, 0, 170, 0, 0, 1.0, 16203, ss: 128 sss: 32 
0x2a364CdDa802Aa76caEA873410E8263575f7D276, 1815, 89, 89, 0, 0, 89, 0, 0, 1.0, 2338, ss: 128 sss: 32 
0xf9f637447182ec98551a72eeb3d97021c3b050fa, 1531, 107, 106, 1, 0, 107, 0, 0, 1.0, 39321, ss: 128 sss: 32 
0x13aa2565955527d20a0dd40970bc77a0a2843cfa, 1745, 139, 134, 5, 0, 139, 0, 0, 1.0, 51243, ss: 128 sss: 32 
0x01ed340e1e925b5ec592744570c53196e27bd018, 2449, 179, 178, 1, 0, 179, 0, 0, 1.0, 31813, ss: 128 sss: 32 
0x64e3af2e74bf5da53a7e40cf7b28f5acec2ac1cc, 1945, 153, 141, 12, 0, 153, 0, 0, 1.0, 53897, ss: 128 sss: 32 
0x3a55eeaf803ef98e908605384a78c6116ff37fa1, 1207, 85, 84, 1, 0, 85, 0, 0, 1.0, 16075, ss: 128 sss: 32 
0xbc36755e696ecf27f727a3ad8d75a55e09139321, 1828, 89, 89, 0, 0, 89, 0, 0, 1.0, 2259, ss: 128 sss: 32 
0x8b9598766bc6e1c503c1562ba64636f7c1e9b57c, 1980, 166, 155, 11, 0, 166, 0, 0, 1.0, 20280, ss: 128 sss: 32 
0x0cee1f59a7cba959e17cc4b266a8927fe2034746, 2417, 177, 175, 2, 0, 177, 0, 0, 1.0, 89689, ss: 128 sss: 32 
0x8326c9cc7778a72d2e16da9ab2a351937a331fb1, 1769, 140, 137, 3, 0, 140, 0, 0, 1.0, 36473, ss: 128 sss: 32 
0x1B4ad253a7dA87e3ECf738a046beF1D8e714cDf8, 2526, 115, 110, 5, 0, 115, 0, 0, 1.0, 68816, ss: 128 sss: 32 
0x41587f0de17E1Fb7e15d905eb2A0d0A300acbf6c, 2807, 195, 186, 9, 0, 195, 0, 0, 1.0, 26824, ss: 128 sss: 32 
0xB7f072db9EA106a83FbB62F204bbaFb49dc9270c, 2949, 273, 256, 17, 0, 273, 0, 0, 1.0, 113068, ss: 128 sss: 32 
0xecd0a174eef8d2deb4dcf989d22c9b9119558d2d, 1508, 107, 106, 1, 0, 107, 0, 0, 1.0, 34976, ss: 128 sss: 32 
0xFe74E113D08Fcb7B6510113EE1E0dA0819862638, 2928, 273, 256, 17, 0, 273, 0, 0, 1.0, 69087, ss: 128 sss: 32 
0x26391e51c32bd18f43df3678df87d5510d43ee36, 631, 36, 36, 0, 0, 36, 0, 0, 1.0, 3965, ss: 128 sss: 32 
0xd8e4ab3ac0d5376e6c3a3a7dd43eda557529a848, 1487, 103, 103, 0, 0, 103, 0, 0, 1.0, 57799, ss: 128 sss: 32 
0xd5ff9ae45e33c028ca1b726ec788e48a70cd5d79, 1590, 110, 109, 1, 0, 110, 0, 0, 1.0, 42988, ss: 128 sss: 32 
0xd5d882de64d5dcc1ae0c622c5489aa85b4ef67aa, 1578, 108, 108, 0, 0, 108, 0, 0, 1.0, 32560, ss: 128 sss: 32 
0xa39c5d7b7c0bf22830cd3da207712acaf5d3cbb7, 2792, 239, 227, 12, 0, 239, 0, 1, 1.0, 18242, ss: 128 sss: 32 
0x7571c67D1A22C3eCC97B070423F02b049597E1b8, 1773, 188, 156, 32, 0, 188, 0, 0, 1.0, 12585, ss: 128 sss: 32 
0x93dc5df459e381084e700de541b42d76b293c7b3, 1513, 107, 106, 1, 0, 107, 0, 0, 1.0, 60368, ss: 128 sss: 32 
0x4020c3c10a585c34dde24da93eff3ec9c0bba96b, 1560, 106, 105, 1, 0, 106, 0, 0, 1.0, 51867, ss: 128 sss: 32 
0xbf0909abfcc0e48875da07bc26fa2a83a6ab8ec1, 1584, 128, 120, 8, 0, 128, 0, 1, 1.0, 32283, ss: 128 sss: 32 
0x5fa684c01f839469ed0d945e4902493b55abcbad, 2007, 139, 138, 1, 0, 139, 0, 0, 1.0, 25621, ss: 128 sss: 32 
0x7485e7ae331c77d9edfc6d187aa9ec9779f03941, 1007, 84, 81, 3, 0, 84, 0, 0, 1.0, 31258, ss: 128 sss: 32 
0x4e9aa03f38bf743deb4cc262a33d57be88f10161, 1365, 96, 95, 1, 0, 96, 0, 0, 1.0, 36944, ss: 128 sss: 32 
0x31fea152f7d6a89543ea2e55f724311e3c09c036, 1816, 89, 89, 0, 0, 89, 0, 0, 1.0, 2850, ss: 128 sss: 32 
0x1223e833d7e86b526606a8f5d88206ea3a8dbaec, 2972, 300, 269, 31, 0, 300, 0, 0, 1.0, 57369, ss: 128 sss: 32 
0x207e84D3c4D1F45746a114EEf4402C79eEF50122, 2892, 249, 235, 14, 0, 249, 0, 0, 1.0, 60532, ss: 128 sss: 32 
0x266eaa5bb51c5dbc7bfeae49567d7b55b6f5003c, 1494, 110, 109, 1, 0, 110, 0, 0, 1.0, 22072, ss: 128 sss: 32 
0x3E368B6C95c6fEfB7A16dCc0D756389F3c658a06, 1704, 136, 131, 5, 0, 136, 0, 1, 1.0, 46762, ss: 128 sss: 32 
0xc69ec3432f8cda053ddf761af3a724e75e99e08d, 1511, 110, 110, 0, 0, 110, 0, 0, 1.0, 27208, ss: 128 sss: 32 
0xc36062d2878c843bcf5df489beb3e029e94a95af, 1432, 101, 100, 1, 0, 101, 0, 0, 1.0, 32595, ss: 128 sss: 32 
0xAe411c69c30de029644a29F9473BEB1ACf5D8bB0, 2847, 245, 228, 17, 0, 245, 0, 0, 1.0, 99756, ss: 128 sss: 32 
0x6540bfaa6b41f27a3dfb8fe5f44b9bd7b678c921, 1872, 152, 148, 4, 0, 152, 0, 0, 1.0, 19064, ss: 128 sss: 32 
0x5759cd0c7e2e0d0032474c79423f798e62aa3a39, 2855, 247, 233, 14, 0, 247, 0, 0, 1.0, 118121, ss: 128 sss: 32 
0x6dbc874eb438ac8a9630506f02f4c9c55409a00d, 2458, 222, 211, 11, 0, 222, 0, 0, 1.0, 40425, ss: 128 sss: 32 
0x5f349cf5e1ad4858fcea0f21f2ea8aff4e679eaa, 1130, 95, 93, 2, 0, 95, 0, 0, 1.0, 51575, ss: 128 sss: 32 
0xcedfdc2b58ac6a5bb8c8dbd535d284180c22a04b, 1816, 131, 129, 2, 0, 131, 0, 0, 1.0, 44042, ss: 128 sss: 32 
0x2e3a5f0efa3060befed753e518d977488afdf845, 1829, 131, 129, 2, 0, 131, 0, 0, 1.0, 24051, ss: 128 sss: 32 
0x47d08cdaf71ea75c9673fbdf99d87ecb381f4ce8, 1516, 107, 106, 1, 0, 107, 0, 0, 1.0, 38137, ss: 128 sss: 32 
0x0787fa6f6d642bc9fcf196db7e9ceb49b8d193ab, 2268, 152, 147, 5, 0, 152, 0, 0, 1.0, 134677, ss: 128 sss: 32 
0x8c9ecd83752067c192b63e07546b8dc27cfe2a98, 2418, 172, 167, 5, 0, 172, 0, 0, 1.0, 52447, ss: 128 sss: 32 
0xa8a8ad82b240ed8f03589e3abf3bf16cec963cce, 1519, 107, 106, 1, 0, 107, 0, 0, 1.0, 40338, ss: 128 sss: 32 
0x356f6ef0b33e14d7349f9e71c0975c2dfce077db, 1518, 107, 106, 1, 0, 107, 0, 0, 1.0, 36778, ss: 128 sss: 32 
0xcc3c9a1e2387c5e74698a3ac3ba91d905d996543, 1050, 103, 103, 0, 0, 103, 0, 0, 1.0, 4882, ss: 128 sss: 32 
0x226e6dc5a9c8186d44c7470a1c3d9f185afa3038, 1510, 107, 106, 1, 0, 107, 0, 0, 1.0, 43347, ss: 128 sss: 32 
0x26dcea4997c431c3a5cb7aea301018244a07aca8, 2306, 220, 209, 11, 0, 220, 0, 0, 1.0, 42200, ss: 128 sss: 32 
0x524fa92a76a6c7eb4909596b393ae18d1ae8ed04, 1494, 104, 103, 1, 0, 104, 0, 0, 1.0, 60992, ss: 128 sss: 32 
0xb68f32e1fa4f91019a07d12e29f5d8991bcc66af, 1935, 153, 141, 12, 0, 153, 0, 0, 1.0, 33194, ss: 128 sss: 32 
0x275460d303ddeaf5e58996c604f066c3033f41a2, 952, 96, 95, 1, 0, 96, 0, 0, 1.0, 5544, ss: 128 sss: 32 
0xaFE3C34D9fF9AAFEfD237323E1cde4d5eEE99cC5, 1828, 89, 89, 0, 0, 89, 0, 0, 1.0, 2934, ss: 128 sss: 32 
0xbab4dbfb6385ecca7c69d1d5a10b6798501c8a5d, 2702, 248, 230, 18, 0, 248, 0, 0, 1.0, 99655, ss: 128 sss: 32 
0xdcd60e2dcd3c833b977c3628ff0b532a02d7de00, 1506, 107, 106, 1, 0, 107, 0, 0, 1.0, 48851, ss: 128 sss: 32 
0x43fe701ad73ec9293a58447e9edc602875f6b5cd, 2742, 212, 201, 11, 0, 212, 0, 0, 1.0, 24752, ss: 128 sss: 32 
0x2b20ee5b54301770ef0e48dd4fc476f5ffbb9403, 1600, 111, 109, 2, 0, 111, 0, 0, 1.0, 50466, ss: 128 sss: 32 
0xa38bdc49fc2dc77a1b302d2b635e88aa85015e76, 1737, 125, 124, 1, 0, 125, 0, 0, 1.0, 37567, ss: 128 sss: 32 
0x89b607bdb24af5127f2ef0e15583aebaaf2d6808, 1585, 108, 108, 0, 0, 108, 0, 0, 1.0, 56549, ss: 128 sss: 32 
0xB617e1D89C99bFfccA472c682Ce18a1f070E5747, 1214, 92, 92, 0, 0, 92, 0, 0, 1.0, 15245, ss: 128 sss: 32 
0x3e0b14f27de8334eada9432d33d3de58a35a0a8b, 1608, 110, 109, 1, 0, 110, 0, 0, 1.0, 39500, ss: 128 sss: 32 
0x50a1f9378a318168d2b880ed5ed48a9ee70afc55, 1598, 110, 110, 0, 0, 110, 0, 0, 1.0, 53912, ss: 128 sss: 32 
0xcb4046c619d313f71beb739f7588a356380f98b4, 1473, 108, 107, 1, 0, 108, 0, 0, 1.0, 28476, ss: 128 sss: 32 
0x4b6737ba4faa7cece23b9fa0f50370a51ac7af16, 1590, 108, 108, 0, 0, 108, 0, 0, 1.0, 35361, ss: 128 sss: 32 
0x3efea1e5f8bbb0dbcd87e6ca7960cfb7c09d0ae9, 2129, 168, 161, 7, 0, 168, 0, 0, 1.0, 25194, ss: 128 sss: 32 
0x9D0352cC19F1b131667e5a9586BF220dd51c3273, 2963, 275, 262, 13, 0, 275, 0, 0, 1.0, 62414, ss: 128 sss: 32 
0x82638019774cadb0b437046443a138600cd62546, 1510, 107, 106, 1, 0, 107, 0, 0, 1.0, 88774, ss: 128 sss: 32 
0x2e38dc1673cda87f65532b5a03053934a42abda1, 1025, 84, 81, 3, 0, 84, 0, 0, 1.0, 19000, ss: 128 sss: 32 
0xc823813B27855356E0556859a2f1a7548dBedE71, 2527, 115, 110, 5, 0, 115, 0, 0, 1.0, 65843, ss: 128 sss: 32 
0x4D8759EDA5Ee085b3019aD0a48081C01FB59F599, 1745, 139, 138, 1, 0, 139, 0, 0, 1.0, 33178, ss: 128 sss: 32 
0x40069889098cd54D6c1021578000F37b197479Cf, 2377, 177, 165, 12, 0, 177, 0, 0, 1.0, 52013, ss: 128 sss: 32 
0x2a345e1c22318e3e07eb4c45614d175de40d68cc, 2757, 190, 180, 10, 0, 190, 0, 0, 1.0, 21214, ss: 128 sss: 32 
0x8edfa22659fbf132d14231aa43b8304738031b2a, 1528, 107, 106, 1, 0, 107, 0, 0, 1.0, 36536, ss: 128 sss: 32 
0x2784f8c79c0100d38d9345d5c63cd98e976b2344, 1512, 107, 106, 1, 0, 107, 0, 0, 1.0, 42496, ss: 128 sss: 32 
0x210dbb010d93c7f843f699190da4fc4064f95260, 494, 26, 26, 0, 0, 26, 0, 0, 1.0, 400, ss: 128 sss: 32 
0x6d1167b5319c6d594491cb1f9279bfa11bf16731, 1918, 172, 159, 13, 0, 172, 0, 0, 1.0, 36407, ss: 128 sss: 32 
0x0b6177141fb299f448c96211ad8ca21f7a3ffb41, 1580, 109, 109, 0, 0, 109, 0, 0, 1.0, 25962, ss: 128 sss: 32 
0xa52fea2dc497e2a18edc170c1c857a30f9a5c842, 2563, 230, 211, 19, 0, 230, 0, 0, 1.0, 41522, ss: 128 sss: 32 
0x3E3B53A5a38e843ec54f2813A530418e8EBF8e1d, 948, 73, 73, 0, 0, 73, 0, 0, 1.0, 1548, ss: 128 sss: 32 
0x78a8c252532ba507dd05b111ece88d615f588fd6, 1523, 107, 106, 1, 0, 107, 0, 0, 1.0, 56703, ss: 128 sss: 32 
0x11d6d434fdff93bfc3a1e9c2923e669939fff73e, 705, 72, 72, 0, 0, 72, 0, 0, 1.0, 8170, ss: 128 sss: 32 
0x4d3a4e3998274f293a2227cbc6ffd160f068a48b, 1502, 104, 103, 1, 0, 104, 0, 0, 1.0, 53903, ss: 128 sss: 32 
0x92cb7068132ef31ddc8aff88b65020877ec600a3, 2905, 278, 270, 8, 0, 278, 0, 0, 1.0, 113001, ss: 128 sss: 32 
0xa0816848d1c31b86a00a508e080dfcd2834e5c40, 1341, 94, 92, 2, 0, 94, 0, 0, 1.0, 43117, ss: 128 sss: 32 
0xBE8dC1e6A01766432EFEF761bb8115B0EdFfdaA3, 2957, 275, 262, 13, 0, 275, 0, 0, 1.0, 119270, ss: 128 sss: 32 
0xd9414d611de1940762d6a56824f263f4241e8879, 1526, 107, 106, 1, 0, 107, 0, 0, 1.0, 59755, ss: 128 sss: 32 
0xb1f13EB56d14f0762E35c4138d002E97a1F7Ffc1, 2389, 225, 214, 11, 0, 225, 0, 0, 1.0, 119243, ss: 128 sss: 32 
0xae91722e3a29aae5c05c39b51f1ff07e2b57dbb2, 2538, 196, 183, 13, 0, 196, 0, 0, 1.0, 40267, ss: 128 sss: 32 
0xc09ea1201fa133c49c025ec0a8f54c2b9bc31a92, 2581, 185, 182, 3, 0, 185, 0, 0, 1.0, 21954, ss: 128 sss: 32 
0x36762cb48dcf260f9c52ede9bfa1de3af159f6e5, 1533, 107, 106, 1, 0, 107, 0, 0, 1.0, 30563, ss: 128 sss: 32 
0x1d59b95ad87f0f4e7e41169d3d85bcc5643ac018, 1026, 84, 81, 3, 0, 84, 0, 0, 1.0, 24438, ss: 128 sss: 32 
0x2e9ba99c8eac6664061007a15e31c0b233582dab, 2917, 262, 233, 29, 0, 262, 0, 0, 1.0, 72208, ss: 128 sss: 32 
0x8fa4bfaafB319a3e2359398B1Cad54ab5CF84414, 493, 43, 40, 3, 0, 43, 0, 0, 1.0, 1174, ss: 128 sss: 32 
0xa40c7e2885af5b105c8ba139c74ee4fb8267fb42, 2632, 182, 176, 6, 0, 182, 0, 0, 1.0, 34682, ss: 128 sss: 32 
0x16465a7163f546c2f4be688d65b9478026ef3545, 1582, 103, 103, 0, 0, 103, 0, 0, 1.0, 47092, ss: 128 sss: 32 
0x1da6121d4442150fbf2e9f6412fe3bd56cbae563, 2446, 217, 213, 4, 0, 217, 0, 0, 1.0, 47690, ss: 128 sss: 32 
0x334aA5996583722cC850344eC02fD99bc263C56d, 1922, 139, 138, 1, 0, 139, 0, 0, 1.0, 31464, ss: 128 sss: 32 
0xcee2fb44bfbd4305d1da245f14d94892eaaa5d95, 1277, 98, 98, 0, 0, 98, 0, 0, 1.0, 18953, ss: 128 sss: 32 
0x6810d3d295f24f7cd14ff0f006a16c6eb57b82fb, 1486, 103, 103, 0, 0, 103, 0, 0, 1.0, 30292, ss: 128 sss: 32 
0x5a25878f9fa438086a547b617674b0c44b04efce, 1262, 99, 98, 1, 0, 99, 0, 0, 1.0, 41130, ss: 128 sss: 32 
0xecaee1ef85994aeec1c5b717ccb8c56568085e79, 1512, 107, 106, 1, 0, 107, 0, 0, 1.0, 31968, ss: 128 sss: 32 
0x1ae2d057befc7d2670d201c924e96f74876308e6, 1521, 108, 106, 2, 0, 108, 0, 0, 1.0, 66240, ss: 128 sss: 32 
0xbdd7e1533d41935ab0c1ae783cacb333b0f8bf6b, 1582, 108, 107, 1, 0, 108, 0, 0, 1.0, 46908, ss: 128 sss: 32 
0x8de4303cf1452815c5b274015a4032a59dd307e6, 2419, 203, 195, 8, 0, 203, 0, 1, 1.0, 35629, ss: 128 sss: 32 
0x7c84ac34fa5be7eb52ffe22a24df8fda8c238319, 1505, 103, 103, 0, 0, 103, 0, 0, 1.0, 72411, ss: 128 sss: 32 
0xc9ba28d3f5175f668d6ab5b1fdf2963a14b7718c, 1506, 107, 106, 1, 0, 107, 0, 0, 1.0, 30886, ss: 128 sss: 32 
0xc36318df21171dc43428f57ebff9f2e0b213bb8c, 1486, 103, 103, 0, 0, 103, 0, 0, 1.0, 37814, ss: 128 sss: 32 
0x9f7b0cDB77F164507734CDf11Cb7062f5BAb1236, 2840, 245, 228, 17, 0, 245, 0, 0, 1.0, 90172, ss: 128 sss: 32 
0xee61e5703d7d61cbe7f1c0aa4e2722a6897e58b7, 2598, 184, 178, 6, 0, 184, 0, 0, 1.0, 43018, ss: 128 sss: 32 
0xf2f2e57787435809cc85efbbff1f98eb49384366, 1523, 107, 106, 1, 0, 107, 0, 0, 1.0, 52497, ss: 128 sss: 32 
0xe036736e5e49b93e82af304e7b48a8c5d5ce7a53, 1493, 103, 103, 0, 0, 103, 0, 0, 1.0, 48847, ss: 128 sss: 32 
0x95E23260A144E17d14d43FaA84Ac92965feAA30F, 1265, 98, 98, 0, 0, 98, 0, 0, 1.0, 43746, ss: 128 sss: 32 
0x287853ea79673e8c1b0fd91ea838984aabfe158e, 1508, 107, 106, 1, 0, 107, 0, 0, 1.0, 54814, ss: 128 sss: 32 
0xa6ca99bacabd985c9407c3c444329accf927b5a6, 2430, 217, 197, 20, 0, 217, 0, 0, 1.0, 45573, ss: 128 sss: 32 
0x9878abc9b4bf492ec38a04166a506320b47834cd, 1507, 107, 106, 1, 0, 107, 0, 0, 1.0, 51802, ss: 128 sss: 32 
0xee8e4fc1fbdf42631d1459c74268f09afdc23334, 1516, 107, 106, 1, 0, 107, 0, 0, 1.0, 28926, ss: 128 sss: 32 
0x3b2c26ec40dfcff1f9637ea9f937c52b333713e0, 1020, 84, 81, 3, 0, 84, 0, 0, 1.0, 20021, ss: 128 sss: 32 
0x6af4e56f3031210158125fa89100785818aa31dc, 2941, 119, 119, 0, 0, 119, 0, 0, 1.0, 24032, ss: 128 sss: 32 
0xBb8121A625cE9f22644909cE9401Aaf05D7Ae3ef, 2057, 146, 144, 2, 0, 146, 0, 0, 1.0, 53258, ss: 128 sss: 32 
0x8a4677081960827f8d253b5a08d31d3b583b3e63, 1539, 107, 106, 1, 0, 107, 0, 0, 1.0, 56454, ss: 128 sss: 32 
0x22c5ff2999bd728eaa91f8a25e9515adec2ee20a, 1374, 108, 107, 1, 0, 108, 0, 0, 1.0, 34195, ss: 128 sss: 32 
0xE017B5767AF09606cB28b1e1EaDaA57bd32E7a45, 2439, 204, 189, 15, 0, 204, 0, 0, 1.0, 44376, ss: 128 sss: 32 
0xcd3623c0a765b1a44cc1e2feedeb4bde34eae636, 1899, 147, 147, 0, 0, 147, 0, 0, 1.0, 38630, ss: 128 sss: 32 
0xc11b651498a30cd35d1c0590379891bd16ef12f7, 1524, 107, 106, 1, 0, 107, 0, 0, 1.0, 34544, ss: 128 sss: 32 
0x8b1770d0e38726a3f9df493dc9b1c9cb29f1b2e6, 2331, 211, 200, 11, 0, 211, 0, 0, 1.0, 116677, ss: 128 sss: 32 
0x185842355304ad4931100f24c0315293296c5392, 1550, 103, 103, 0, 0, 103, 0, 0, 1.0, 37989, ss: 128 sss: 32 
0xb947ab3CA82511c16fC02b9Ee11fFfCFe99856Ea, 2949, 275, 262, 13, 0, 275, 0, 0, 1.0, 70685, ss: 128 sss: 32 
0xce6f6d4897b85c4977052fcfa7d48657850415e3, 1498, 110, 110, 0, 0, 110, 0, 0, 1.0, 31073, ss: 128 sss: 32 
0x834b03e66490999fd0230c53b4fe4db3d23dd511, 1514, 107, 106, 1, 0, 107, 0, 0, 1.0, 54348, ss: 128 sss: 32 
0x2c215eff8396f06048bf115c2735ba931de919a7, 1614, 113, 112, 1, 0, 113, 0, 0, 1.0, 26411, ss: 128 sss: 32 
0x72a9320502aa363a39c52ba9e46f9ed4d87fd036, 2310, 220, 209, 11, 0, 220, 0, 0, 1.0, 59615, ss: 128 sss: 32 
0x6214f55959837e47e119d55fd9875e7777b363ca, 1491, 108, 107, 1, 0, 108, 0, 0, 1.0, 25289, ss: 128 sss: 32 
0x172A744e27B1Eb58BeCC028Ce7294Fd3e685A2Ae, 1355, 120, 118, 2, 0, 120, 0, 0, 1.0, 10292, ss: 128 sss: 32 
0xC15091D3478296fD522B2807a9541578910DCC41, 705, 53, 53, 0, 0, 53, 0, 0, 1.0, 14380, ss: 128 sss: 32 
0xb73ddf6ad80ae85f37a5918a67fece2caa591440, 1366, 96, 95, 1, 0, 96, 0, 0, 1.0, 16217, ss: 128 sss: 32 
0x7ddf184030825e5473d561f25cf0e2cb9ef9bdee, 1510, 107, 106, 1, 0, 107, 0, 0, 1.0, 53279, ss: 128 sss: 32 
0x4b3372f61ADf54ccaC8d345313F96766EA69eCDD, 2325, 205, 195, 10, 0, 205, 0, 0, 1.0, 56049, ss: 128 sss: 32 
0x8fb57bade1d83136803887071caefba116086aa8, 1213, 87, 87, 0, 0, 87, 0, 0, 1.0, 8388, ss: 128 sss: 32 
0x60d84B721293aa4C0D2Dc826068521Bd972f02E5, 183, 8, 6, 2, 0, 8, 0, 0, 1.0, 17, ss: 128 sss: 32 
0xf1d342bb09b44c8b1c4920e820b3199ca43306dc, 1515, 107, 106, 1, 0, 107, 0, 0, 1.0, 33347, ss: 128 sss: 32 
0x9aE96406933073F62Ad3ee8d2637B9e8aaDFC515, 2971, 276, 262, 14, 0, 276, 0, 0, 1.0, 115366, ss: 128 sss: 32 
0xa596b580c05e2cf8ddd83c3019786061d3743a43, 2388, 168, 164, 4, 0, 168, 0, 0, 1.0, 48508, ss: 128 sss: 32 
0xb05f23BcD2e0713062b22c641F03591B101fBD94, 2535, 115, 110, 5, 0, 115, 0, 0, 1.0, 64706, ss: 128 sss: 32 
0x9174e29ca6552486b250507a2677b5224cf77c13, 1589, 107, 106, 1, 0, 107, 0, 0, 1.0, 35099, ss: 128 sss: 32 
0x608b9e7acd60732a4508871e76fb68fed4745909, 2135, 174, 166, 8, 0, 174, 0, 0, 1.0, 56731, ss: 128 sss: 32 
0xfeb23e20ee3e92486ffd7c5e1aaeef0baaa2bdfa, 2861, 248, 223, 25, 0, 248, 0, 0, 1.0, 42012, ss: 128 sss: 32 
0xed3fe3dd55fe266400151404c0cea8d0beeda750, 1429, 100, 99, 1, 0, 100, 0, 0, 1.0, 21167, ss: 128 sss: 32 
0x94729784657b556370438597c7929110641c29c9, 825, 83, 83, 0, 0, 83, 0, 0, 1.0, 9369, ss: 128 sss: 32 
0xee698678f5c5cbc9c5b938326b3e6d15b113d345, 1599, 110, 110, 0, 0, 110, 0, 0, 1.0, 48351, ss: 128 sss: 32 
0x01ad560dFc0c71d1349A4BF18F51aBc3eCeAF48e, 2487, 231, 222, 9, 0, 231, 0, 0, 1.0, 14499, ss: 128 sss: 32 
0xc5f744fec2f357d3ba2f8f67f0c7cc5ecf8bdc93, 1614, 115, 114, 1, 0, 115, 0, 0, 1.0, 64338, ss: 128 sss: 32 
0x7306823FBb77b7faffb71267234cc5D8c7DcF259, 2942, 273, 256, 17, 0, 273, 0, 0, 1.0, 47693, ss: 128 sss: 32 
0x649ecc3cdd3eabd7391a6408b4725ece79bfd5b2, 1519, 107, 106, 1, 0, 107, 0, 0, 1.0, 32479, ss: 128 sss: 32 
0x23c7a91024855983001ad5d0cd866f60646c6b64, 1508, 107, 106, 1, 0, 107, 0, 0, 1.0, 37076, ss: 128 sss: 32 
0xa4d6262a3be1a5f25716d26e69218917cb200adc, 1522, 127, 127, 0, 0, 127, 0, 0, 1.0, 28967, ss: 128 sss: 32 
0x5ae0b3223f333b910ff8f6a5daffe451db366b61, 1590, 109, 108, 1, 0, 109, 0, 0, 1.0, 19541, ss: 128 sss: 32 
0x6Cc65bF618F55ce2433f9D8d827Fc44117D81399, 2415, 140, 133, 7, 0, 140, 0, 0, 1.0, 7338, ss: 128 sss: 32 
0x58427ae12C559a5376918b11ce0C88564452ecE6, 2215, 143, 139, 4, 0, 143, 0, 0, 1.0, 19981, ss: 128 sss: 32 
0x7d562871dfd88375b593ead85f432fd5ba7febe0, 2887, 278, 270, 8, 0, 278, 0, 0, 1.0, 134976, ss: 128 sss: 32 
0x9034abf412f65737a8b84f05a550357bf0aad266, 1454, 119, 118, 1, 0, 119, 0, 0, 1.0, 21417, ss: 128 sss: 32 
0x3205809e0340f49b1adb6b1b7bfed21400c8b59d, 999, 100, 96, 4, 0, 100, 0, 0, 1.0, 70882, ss: 128 sss: 32 
0x5e01132ef457a08263c760f7c334428a4a5b5602, 1661, 116, 114, 2, 0, 116, 0, 0, 1.0, 14350, ss: 128 sss: 32 
0xfc1effb415e5fb6115f82b1788ad36e34599035b, 2152, 197, 189, 8, 0, 197, 0, 0, 1.0, 70806, ss: 128 sss: 32 
0x01eff4e664a806e4b641a60bd4bbd04b4d090e89, 1344, 94, 92, 2, 0, 94, 0, 0, 1.0, 35539, ss: 128 sss: 32 
0x29e3cd942a4e1a39c40e98ce528c010b40375b87, 1639, 114, 113, 1, 0, 114, 0, 0, 1.0, 36417, ss: 128 sss: 32 
0xa4EcD076E956Fde75b83fC75E62DA9002E321828, 2761, 263, 245, 18, 0, 263, 0, 0, 1.0, 108401, ss: 128 sss: 32 
0x1ef14c4afbd73b2faf8a1f1bc31f088d4ce1d548, 608, 23, 23, 0, 0, 23, 0, 0, 1.0, 319, ss: 128 sss: 32 
0x23f8dec716699941bade7a3751dcb21000b29d39, 1817, 89, 89, 0, 0, 89, 0, 0, 1.0, 3102, ss: 128 sss: 32 
0x5718c5f52b3a596218f6879d03598423f05caa25, 2153, 197, 189, 8, 0, 197, 0, 0, 1.0, 70797, ss: 128 sss: 32 
0x71e9e74491de234d78a7da6d5ad2935148057e03, 1012, 84, 81, 3, 0, 84, 0, 0, 1.0, 46164, ss: 128 sss: 32 
0xe532ee26641438c24a5409cdd5a707731052d8e5, 980, 38, 36, 2, 0, 38, 0, 0, 1.0, 1353, ss: 128 sss: 32 
0x8ea7abf7e42f6dd8bdf2bb2817dcea2b89bb1a4e, 1529, 107, 106, 1, 0, 107, 0, 0, 1.0, 62404, ss: 128 sss: 32 
0xf7b265c2be85a4a5f9bd0ed4642f57b0eca7c530, 374, 31, 31, 0, 0, 31, 0, 0, 1.0, 134, ss: 128 sss: 32 
0x7439286ce053c777d7108096d7b0a14cc5d8dfe5, 1519, 107, 106, 1, 0, 107, 0, 0, 1.0, 49594, ss: 128 sss: 32 
0x217547248d135d143b4c974168782d3906515eb9, 1004, 84, 81, 3, 0, 84, 0, 0, 1.0, 21359, ss: 128 sss: 32 
0xf5ef38ad15fb41bf066ccd9b738a26462b3701d2, 1916, 147, 147, 0, 0, 147, 0, 0, 1.0, 22880, ss: 128 sss: 32 
0xb12c05c7e540832d05c2007bb92088661232dc88, 2678, 93, 93, 0, 0, 93, 0, 0, 1.0, 9003, ss: 128 sss: 32 
0x3374f2ca7010ec864119c5f2c475248165f1be47, 1504, 107, 106, 1, 0, 107, 0, 0, 1.0, 35414, ss: 128 sss: 32 
0xf3673fc56376bc9b37f9d11e90e35d8f67c16d64, 1565, 108, 107, 1, 0, 108, 0, 0, 1.0, 22800, ss: 128 sss: 32 
0x1f47a4a4fc670b7368439fb959bde29b3ecdada6, 1583, 107, 106, 1, 0, 107, 0, 0, 1.0, 36665, ss: 128 sss: 32 
0xe3ad423a2bfc2dc482ae2f4256270b9dd8e95f0c, 1524, 107, 106, 1, 0, 107, 0, 0, 1.0, 73129, ss: 128 sss: 32 
0xd8dbdc9ce97145957ad8c5811782591706549c67, 1527, 107, 106, 1, 0, 107, 0, 0, 1.0, 59259, ss: 128 sss: 32 
0xACAB00Aa1a8E30Ce25c22d3c4E2535caB7EEc3c8, 2869, 248, 223, 25, 0, 248, 0, 0, 1.0, 66508, ss: 128 sss: 32 
0xC9FEa8E7C83BDCB5b425e3e72e5913A43061CA4B, 2231, 197, 185, 12, 0, 197, 0, 0, 1.0, 59116, ss: 128 sss: 32 
0x04381f1bcd3356da650c5768ef62dc24c79ae5fc, 2219, 207, 195, 12, 0, 207, 0, 0, 1.0, 66824, ss: 128 sss: 32 
0xe453c05fccf09e79e1c19bb416dbe4bd2be6e293, 1776, 140, 137, 3, 0, 140, 0, 0, 1.0, 39578, ss: 128 sss: 32 
0x17B64A8eEF3E907c8d66D5cE94b6d7Cb77116be5, 2944, 273, 257, 16, 0, 273, 0, 0, 1.0, 67587, ss: 128 sss: 32 
0x79c23b90d0cd3055f6383d33a0c62bbb3c1c7223, 1525, 107, 106, 1, 0, 107, 0, 0, 1.0, 36110, ss: 128 sss: 32 
0xa13d520aeacf4841318fb843ff9a8905cfeb9d34, 1522, 107, 106, 1, 0, 107, 0, 0, 1.0, 39850, ss: 128 sss: 32 
0xe35Bb4c45A03b9Ce377A0BB03C489eB84A6F50E6, 2960, 276, 262, 14, 0, 276, 0, 0, 1.0, 69528, ss: 128 sss: 32 
0xa7597dc0b9b69a76bd7b55e5ceedc5f08544f99f, 1519, 107, 106, 1, 0, 107, 0, 0, 1.0, 75962, ss: 128 sss: 32 
0x79b5e7809058d1f25a27336fd7cde51d1569b53f, 1512, 107, 106, 1, 0, 107, 0, 0, 1.0, 81046, ss: 128 sss: 32 
0x26bcf3a55ce2c176ca27d48aec76ee71090c0e18, 1172, 98, 95, 3, 0, 98, 0, 0, 1.0, 11536, ss: 128 sss: 32 
0x231608329b1a6dde9f3da31104714c4ad277fce7, 1271, 87, 87, 0, 0, 87, 0, 0, 1.0, 25044, ss: 128 sss: 32 
0x1b1ba0a337a526987f97c9c42365f0358aa97cad, 1332, 94, 92, 2, 0, 94, 0, 0, 1.0, 31630, ss: 128 sss: 32 
0xa6ab5ea87613c6b17f69234448bce5276961b37a, 2335, 174, 168, 6, 0, 174, 0, 0, 1.0, 27041, ss: 128 sss: 32 
0xc6f7fa4510f26f88a053208f760926ce70fab451, 2045, 151, 150, 1, 0, 151, 0, 0, 1.0, 72826, ss: 128 sss: 32 
0x04003653ca222d36c73d2970a65ec576d6035cd3, 2397, 166, 163, 3, 0, 166, 0, 0, 1.0, 87870, ss: 128 sss: 32 
0xbecc9bb2e970101dce5518b67b9ee85be62d85e0, 1480, 103, 103, 0, 0, 103, 0, 0, 1.0, 73616, ss: 128 sss: 32 
0xcb96c64c94573e3786ae19bd3ce09a78903b6950, 1583, 110, 110, 0, 0, 110, 0, 0, 1.0, 32876, ss: 128 sss: 32 
0x8aa83bef9ef503d72be1c23c8c789f83b03ca32e, 2958, 276, 262, 14, 0, 276, 0, 0, 1.0, 143436, ss: 128 sss: 32 
0xd2e9c996b88def4ffc57a64cf8a16f6809ffa9c2, 2427, 226, 215, 11, 0, 226, 0, 0, 1.0, 47399, ss: 128 sss: 32 
0x6dd5a1ee97883a5544d165d601bcd7dd316af24f, 1540, 101, 100, 1, 0, 101, 0, 0, 1.0, 32634, ss: 128 sss: 32 
0x24aBa5d98c4aCC4f7504Fa1Acc46e6304d9fFa73, 1922, 173, 165, 8, 0, 173, 0, 0, 1.0, 71945, ss: 128 sss: 32 
0x9dDA9063D5b86CD3fa5Fa316fE0B0E9bd2f85A41, 2186, 143, 139, 4, 0, 143, 0, 0, 1.0, 38522, ss: 128 sss: 32 
0x05Be534AfEfFDe5ff66e44696b35C2dC0fCDfF90, 1703, 148, 148, 0, 0, 148, 0, 0, 1.0, 33625, ss: 128 sss: 32 
0x39bfC76cf7dd2c7B9F666E089e70D68D39D041E4, 588, 34, 34, 0, 0, 34, 0, 0, 1.0, 287, ss: 128 sss: 32 
0xb84525035393af70d7e04617e0df61473338bb4f, 1519, 107, 106, 1, 0, 107, 0, 0, 1.0, 44551, ss: 128 sss: 32 
0xbc9D05517c10b14B241B6bB1c1149E337Fd80e4B, 645, 58, 58, 0, 0, 58, 0, 0, 1.0, 4378, ss: 128 sss: 32 
0x09330fe2e59b1bdf9938a2e9d3501dfd806f06aa, 1636, 114, 112, 2, 0, 114, 0, 0, 1.0, 16161, ss: 128 sss: 32 
0x6f6f4646125db4e882eaf9fe08a712d0e6c180c1, 1354, 96, 95, 1, 0, 96, 0, 0, 1.0, 38669, ss: 128 sss: 32 
0x0ea12fd4fb1d8c4c0936395deceb34f6838e2ba4, 1511, 107, 106, 1, 0, 107, 0, 0, 1.0, 53376, ss: 128 sss: 32 
0x990b5955c4631765b876eadc60650f96f14cf406, 2834, 245, 227, 18, 0, 245, 0, 0, 1.0, 95841, ss: 128 sss: 32 
0x685d4cc285186ec67efd68a62bcc8532921d370e, 2325, 161, 157, 4, 0, 161, 0, 0, 1.0, 89616, ss: 128 sss: 32 
0x1d4ff8afe044b688d38f06374262530bead617e3, 1502, 110, 110, 0, 0, 110, 0, 0, 1.0, 33598, ss: 128 sss: 32 
0xf44daa13380e597e787751c678f98f00b5a66ed4, 2393, 220, 205, 15, 0, 220, 0, 0, 1.0, 77682, ss: 128 sss: 32 
0x2092202d26417fd0aa4e3802e7ce339f8e8f0695, 2743, 181, 174, 7, 0, 181, 0, 0, 1.0, 64376, ss: 128 sss: 32 
0x3db047603337ffa64ee57594ae522e2467c54d00, 1514, 108, 106, 2, 0, 108, 0, 0, 1.0, 72454, ss: 128 sss: 32 
0x05eaf0B7C7954ED6b4ae7b65F20A9af616DF14b3, 2881, 247, 233, 14, 0, 247, 0, 0, 1.0, 93991, ss: 128 sss: 32 
0x4e79234e298b7fa11a2116c7b12258f658b0ccbd, 1504, 108, 107, 1, 0, 108, 0, 0, 1.0, 42381, ss: 128 sss: 32 
0x59f781f0fde6585d88702f6fff25fac2c7b40a00, 1521, 108, 106, 2, 0, 108, 0, 0, 1.0, 61357, ss: 128 sss: 32 
0xc8bc736db70f337483177dc80d747e8cabb53b82, 2859, 247, 234, 13, 0, 247, 0, 0, 1.0, 110463, ss: 128 sss: 32 
0x0a976384d68039C311bD8a4bb9711451c2001A43, 1329, 87, 87, 0, 0, 87, 0, 0, 1.0, 31537, ss: 128 sss: 32 
0x3aabbc20f16e5b5061de3403e495b93c5985b82d, 1790, 164, 156, 8, 0, 164, 0, 0, 1.0, 16649, ss: 128 sss: 32 
0xa8a3641d9eb1e81e0ff1f33a7a13346a11fa0001, 1525, 107, 106, 1, 0, 107, 0, 0, 1.0, 40624, ss: 128 sss: 32 
0x723c27c91e88909dbd0e8033fda53a85b2500231, 1209, 87, 87, 0, 0, 87, 0, 0, 1.0, 14106, ss: 128 sss: 32 
0xecaebdf3c6f3ac7f28265226d5f5e1b788f19e02, 2507, 173, 170, 3, 0, 173, 0, 0, 1.0, 72712, ss: 128 sss: 32 
0xDb0acDE24816c0F75536351056Ec5D6dffb7CFc7, 2867, 259, 253, 6, 0, 259, 0, 0, 1.0, 78222, ss: 128 sss: 32 
0x2696eF8a208Ec4c8f5500df2a80594F8dAaed253, 2873, 248, 235, 13, 0, 248, 0, 0, 1.0, 68326, ss: 128 sss: 32 
0xeb79563d45fb4a0a0513b9d4dec3944aaf53ac20, 1227, 87, 87, 0, 0, 87, 0, 0, 1.0, 16471, ss: 128 sss: 32 
0x5CDE9fec66D89B931fB7a5DB8cFf2cDb642f4e7d, 801, 68, 64, 4, 0, 68, 0, 0, 1.0, 317, ss: 128 sss: 32 
0x448DA008c7EB2501165c9Aa62DfFEeC4405bC660, 2968, 126, 125, 1, 0, 126, 0, 0, 1.0, 20694, ss: 128 sss: 32 
0xa3a9c2717ec318c60efd58294da59db4e6bbb0d5, 2423, 226, 215, 11, 0, 226, 0, 0, 1.0, 91849, ss: 128 sss: 32 
0xc006faaf642c93f23e2f9f03c1663fb9bc4606f7, 1520, 108, 106, 2, 0, 108, 0, 0, 1.0, 71627, ss: 128 sss: 32 
0xD6Cc86679374D09CAF3Bd86817e7f6dC503AF513, 2952, 275, 262, 13, 0, 275, 0, 0, 1.0, 67737, ss: 128 sss: 32 
0x9326a67492bc480dbd0fb33bb9b414d26c597822, 1514, 107, 106, 1, 0, 107, 0, 0, 1.0, 59839, ss: 128 sss: 32 
0x913badcbee9c7cdd159fc774285d7788da0c2ab0, 2936, 263, 248, 15, 0, 263, 0, 0, 1.0, 79646, ss: 128 sss: 32 
0x49069ad4c2e61176f39f6fed435ef8f6712e0997, 1514, 107, 106, 1, 0, 107, 0, 0, 1.0, 34186, ss: 128 sss: 32 
0xba224c7a72c9b27c3eebb75327f42229123c5651, 1517, 107, 106, 1, 0, 107, 0, 0, 1.0, 32655, ss: 128 sss: 32 
0xdc658205b287d2341376205417be846c5adc09dc, 1516, 107, 106, 1, 0, 107, 0, 0, 1.0, 41913, ss: 128 sss: 32 
0x7bc037dd4cbfe6f9f175093acab4267fde24667c, 2781, 245, 232, 13, 0, 245, 0, 0, 1.0, 44389, ss: 128 sss: 32 
0x0A29E0CF31cD4F524C7a231eca4198c2160Ab5cE, 2834, 245, 228, 17, 0, 245, 0, 0, 1.0, 120892, ss: 128 sss: 32 
0x15ae93cbc0569430669109116a7547322119349b, 1495, 108, 107, 1, 0, 108, 0, 0, 1.0, 43754, ss: 128 sss: 32 
0xbf19dd68189eabd4eb3de656e6c04a7df7b271bc, 1388, 110, 110, 0, 0, 110, 0, 0, 1.0, 27893, ss: 128 sss: 32 
0x2658b1e51b0f32b1d67427cc1b5cc7f170acb0b1, 2139, 195, 183, 12, 0, 195, 0, 0, 1.0, 72837, ss: 128 sss: 32 
0x35d647707a95729987f18bbab6ea6e8becb3c682, 1535, 108, 106, 2, 0, 108, 0, 0, 1.0, 35462, ss: 128 sss: 32 
0x3683dcf66e649a3566fd15e546d139b72005df54, 1635, 113, 112, 1, 0, 113, 0, 0, 1.0, 18382, ss: 128 sss: 32 
0x5b6989871b48b9ff914eb77439ed22a7fb5a6146, 2412, 200, 191, 9, 0, 200, 0, 0, 1.0, 70730, ss: 128 sss: 32 
0xfefe003C8907dA55611EE27DA8E6b267515a0e26, 2352, 205, 195, 10, 0, 205, 0, 0, 1.0, 84697, ss: 128 sss: 32 
0xd36608023c01676a745ff342315b9d3502e9d49a, 2562, 230, 211, 19, 0, 230, 0, 0, 1.0, 84237, ss: 128 sss: 32 
0x8a99c3c39993aa02152b2b12ca37d5c87d4baa1a, 1516, 107, 106, 1, 0, 107, 0, 0, 1.0, 51454, ss: 128 sss: 32 
0x3842cdd7164ba116892975d56544d0e0c734743c, 2912, 278, 270, 8, 0, 278, 0, 0, 1.0, 69625, ss: 128 sss: 32 
0x309eeadaee8ed22eacaa4b951305d9b6abb630bb, 1518, 107, 106, 1, 0, 107, 0, 0, 1.0, 32534, ss: 128 sss: 32 
0x7b8f9D1f7444C86A1263C4A88f56A0471320b103, 1569, 103, 103, 0, 0, 103, 0, 0, 1.0, 18648, ss: 128 sss: 32 
0x5d3be009b0d16a89048985e6655cd6afa75b057b, 1364, 99, 98, 1, 0, 99, 0, 0, 1.0, 21179, ss: 128 sss: 32 
0xe845fa17197296165d1ecd7c170db2fb11b5976f, 1523, 107, 106, 1, 0, 107, 0, 0, 1.0, 51647, ss: 128 sss: 32 
0xcd41e74c897271d765bbc1167138796e52786b65, 1644, 114, 111, 3, 0, 114, 0, 0, 1.0, 10331, ss: 128 sss: 32 
0xF0A3c2D4E81ACcc8e3Ac3aCCd50F5294601f88Cf, 2525, 115, 110, 5, 0, 115, 0, 0, 1.0, 60841, ss: 128 sss: 32 
0x21ab3d8641567433cee828299149aa34db6dbd77, 2859, 247, 234, 13, 0, 247, 0, 0, 1.0, 70640, ss: 128 sss: 32 
0x345d723125a9ec2e32c735e1da02b4ac63e2f8ea, 1513, 107, 106, 1, 0, 107, 0, 0, 1.0, 72229, ss: 128 sss: 32 
0x2715770bd7b23165bc9ee82c4c865c73ad2f21b5, 2832, 198, 189, 9, 0, 198, 0, 0, 1.0, 31963, ss: 128 sss: 32 
0xf75452f257bca0e0aa093e9717870a38dd0fc735, 1498, 108, 107, 1, 0, 108, 0, 0, 1.0, 27443, ss: 128 sss: 32 
0x5c6bf573687b5248a3f67643803c2c862b5685fe, 1944, 161, 154, 7, 0, 161, 0, 0, 1.0, 53979, ss: 128 sss: 32 
0x818b4c8be2ceb30b2707f7fc0257ec14d532472a, 1508, 107, 106, 1, 0, 107, 0, 0, 1.0, 52817, ss: 128 sss: 32 
0x1e9707b33f3bedffec86378ed543666b9adb1915, 2973, 256, 224, 32, 0, 256, 0, 0, 1.0, 73990, ss: 128 sss: 32 
0x6957009404c6625BA4D0d9D93Bef74420a91B5C3, 2592, 194, 185, 9, 0, 194, 0, 0, 1.0, 71859, ss: 128 sss: 32 
0x4913316b6d5855bb4c5e3fccd75d7ce70d53c941, 2865, 247, 233, 14, 0, 247, 0, 0, 1.0, 56026, ss: 128 sss: 32 
0x3ee4a5b965699d0706fa98c80855423f3f9d6c2c, 2073, 156, 156, 0, 0, 156, 0, 0, 1.0, 43522, ss: 128 sss: 32 
0xb86e4247e69d413dae263e7650206b7aff69ffce, 2659, 265, 252, 13, 0, 265, 0, 2, 1.0, 45465, ss: 128 sss: 32 
0x03687f9151785798cadee2ff0621113858d6541e, 2444, 218, 194, 24, 0, 218, 0, 0, 1.0, 93985, ss: 128 sss: 32 
0x75540443f40f21b1977b1d9a1755ac9b1e8cbfae, 1522, 107, 106, 1, 0, 107, 0, 0, 1.0, 63892, ss: 128 sss: 32 
0x780cb3adc27abfd6824406ce276220fa5a852863, 1784, 140, 137, 3, 0, 140, 0, 0, 1.0, 40388, ss: 128 sss: 32 
0x4cd17ff0b4bda0635eec559cedfb24130c291890, 1902, 171, 159, 12, 0, 171, 0, 0, 1.0, 61592, ss: 128 sss: 32 
0xe3748b86a559fc91b66d957c26732feddfaf0785, 1503, 110, 110, 0, 0, 110, 0, 0, 1.0, 52711, ss: 128 sss: 32 
0x5aee15d83b50ab6909375242642ea3cedeb06b39, 1399, 110, 110, 0, 0, 110, 0, 0, 1.0, 16204, ss: 128 sss: 32 
0xf687973a18915962acac67570ca267f45d875604, 900, 72, 72, 0, 0, 72, 0, 1, 1.0, 5534, ss: 128 sss: 32 
0xd3bd47d109fabe717dea185b9f337b258cf0eec7, 1596, 110, 110, 0, 0, 110, 0, 0, 1.0, 53328, ss: 128 sss: 32 
0xb33B94A471dA5d54bfC40C80D43b1F4Fc5F4D14D, 1311, 87, 87, 0, 0, 87, 0, 0, 1.0, 46434, ss: 128 sss: 32 
0xb2695d83b8fdd7d7b20e54318e8bda89e97e2391, 1022, 84, 81, 3, 0, 84, 0, 0, 1.0, 27263, ss: 128 sss: 32 
0x6c8804f4ef30fcc9e54eb217dcbf1d687b32ce28, 2924, 263, 248, 15, 0, 263, 0, 0, 1.0, 42131, ss: 128 sss: 32 
0x4a487fe7f26a9ff521797c13cc2238c8d7cfc1b8, 1578, 107, 106, 1, 0, 107, 0, 0, 1.0, 23855, ss: 128 sss: 32 
0x51a2df312e19e1a144622e75fb5a04de97fb9d96, 2587, 247, 231, 16, 0, 247, 0, 0, 1.0, 45717, ss: 128 sss: 32 
0x60fd723f7a5153726805ceee5b97cce427113222, 1610, 115, 114, 1, 0, 115, 0, 0, 1.0, 41719, ss: 128 sss: 32 
0x49bfb6322600eac78b81e650e7b9329b613e38b8, 1503, 107, 106, 1, 0, 107, 0, 0, 1.0, 79879, ss: 128 sss: 32 
0x8fdbc4535802f2c338527a5aae0e510a821a62d7, 1517, 107, 106, 1, 0, 107, 0, 0, 1.0, 30293, ss: 128 sss: 32 
0x60e5844bee00741aa37b7aa7f1ed432e5025ec68, 1513, 107, 106, 1, 0, 107, 0, 0, 1.0, 53312, ss: 128 sss: 32 
0x10350ac44c0d3f6c4abd55d32409ac31d4bd5087, 1893, 147, 147, 0, 0, 147, 0, 0, 1.0, 22763, ss: 128 sss: 32 
0x5806c0d97b2443a431465555647e0240ea675053, 1518, 107, 106, 1, 0, 107, 0, 0, 1.0, 60119, ss: 128 sss: 32 
0xe0b2c86bbfde4827dc99f2ed41cbabfd32d07140, 1522, 107, 106, 1, 0, 107, 0, 0, 1.0, 32316, ss: 128 sss: 32 
0x342b7d733e8f8da6214794d7f3b7e8680964d9b3, 2421, 226, 215, 11, 0, 226, 0, 0, 1.0, 79927, ss: 128 sss: 32 
0x5f88dbcaa6993f2d633b2ccb177a935e16252bcb, 1528, 107, 106, 1, 0, 107, 0, 0, 1.0, 65067, ss: 128 sss: 32 
0xb5E563654CaB985CA323E496c8ca47f498B129d5, 2160, 175, 173, 2, 0, 175, 0, 0, 1.0, 28366, ss: 128 sss: 32 
0x5f8daaf83237B3659cdfcEb5D7DD2f4C7C6a0068, 1916, 171, 159, 12, 0, 171, 0, 0, 1.0, 35161, ss: 128 sss: 32 
0x30cf5ccc98a8ea9d661d44f73905e0c7b1bcb8d6, 1391, 99, 98, 1, 0, 99, 0, 0, 1.0, 20656, ss: 128 sss: 32 
0x795b23627bdeae607b56baae6993617de17d7180, 1517, 107, 106, 1, 0, 107, 0, 0, 1.0, 68357, ss: 128 sss: 32 
0x3ca49efbec52bc21a93630c7eac6c9c59f14cda5, 2883, 278, 270, 8, 0, 278, 0, 0, 1.0, 78580, ss: 128 sss: 32 
0xb25ed10bfc10fa5e58ca6b46b5cb9bc8fbbe6d36, 1337, 94, 92, 2, 0, 94, 0, 0, 1.0, 31138, ss: 128 sss: 32 
0xe5ec11984a6e42927dfb7e5739512a2bf0b0d6dc, 1517, 107, 106, 1, 0, 107, 0, 0, 1.0, 85831, ss: 128 sss: 32 
0x11ecc620b7b89e49f0eb2170604fc35c2442b710, 1514, 107, 106, 1, 0, 107, 0, 0, 1.0, 37573, ss: 128 sss: 32 
0xeccf48d831889ba28ce3f7724381f141c2dc987b, 1208, 91, 90, 1, 0, 91, 0, 0, 1.0, 26105, ss: 128 sss: 32 
0x8f441d5880361fff1da43f4909b5b4ebf5dec99a, 1020, 84, 81, 3, 0, 84, 0, 0, 1.0, 17393, ss: 128 sss: 32 
0xe7db0c55c8a6d7d5c21696dd41570e344f0bfd63, 1829, 89, 89, 0, 0, 89, 0, 0, 1.0, 6736, ss: 128 sss: 32 
0xac6379d45eb659822a68a3db81486372433143b1, 2413, 168, 163, 5, 0, 168, 0, 0, 1.0, 87851, ss: 128 sss: 32 
0x4fb610a0be1965b943ee17df7c7d80071835e056, 705, 38, 38, 0, 0, 38, 0, 0, 1.0, 358, ss: 128 sss: 32 
0xe969316df156031965b6974078d4da03c5a967c7, 2429, 226, 215, 11, 0, 226, 0, 0, 1.0, 87972, ss: 128 sss: 32 
0x833d4379940f3b30b0d258d3fd1258ad51222e0c, 2061, 151, 150, 1, 0, 151, 0, 0, 1.0, 77630, ss: 128 sss: 32 
0x8142709896850e5532983f25a26e36dcc3eab5fc, 697, 69, 69, 0, 0, 69, 0, 0, 1.0, 5806, ss: 128 sss: 32 
0x3e0e7d1388338556a707d3bb6ebfd1bdef9618f3, 1495, 103, 103, 0, 0, 103, 0, 0, 1.0, 66447, ss: 128 sss: 32 
0x9fd5236dc380cb17c85e47ad0c92ab4421227dd8, 1511, 107, 106, 1, 0, 107, 0, 0, 1.0, 62979, ss: 128 sss: 32 
0x9cfd5e0aed87c614e218aeb3da4728c281f36997, 1588, 108, 108, 0, 0, 108, 0, 0, 1.0, 48303, ss: 128 sss: 32 
0xE6685f9C0CA08e6D12bb83281629a32204eEAb48, 2267, 168, 156, 12, 0, 168, 0, 0, 1.0, 48066, ss: 128 sss: 32 
0x2d81de318b65381c470d16431fba4f7b18f0351f, 1512, 107, 106, 1, 0, 107, 0, 0, 1.0, 67024, ss: 128 sss: 32 
0x5c94EDdfCb674917A049a21B59cD348029649B29, 2331, 203, 190, 13, 0, 203, 0, 0, 1.0, 84155, ss: 128 sss: 32 
0xa7ac2dfcc71b0b8b75fb9e16448949d97fe513ae, 1516, 107, 106, 1, 0, 107, 0, 0, 1.0, 58815, ss: 128 sss: 32 
0xa8ba8d813b8a952cdc87e27480e8645c36e3e671, 2362, 173, 173, 0, 0, 173, 0, 0, 1.0, 35001, ss: 128 sss: 32 
0x680dd4eab93201fc5d5de66d45ec0187290b6a7b, 1512, 107, 106, 1, 0, 107, 0, 0, 1.0, 52201, ss: 128 sss: 32 
0xf37e918697635c0eed40979ec3cbd1298347f66c, 1110, 83, 83, 0, 0, 83, 0, 0, 1.0, 27004, ss: 128 sss: 32 
0x06e29544bd4e9548d16c7a043adfa6b1567defe1, 425, 44, 44, 0, 0, 44, 0, 0, 1.0, 483, ss: 128 sss: 32 
0x04729ae5f2b39709e4a7b20903566e1c6bca19c2, 1892, 147, 147, 0, 0, 147, 0, 0, 1.0, 33216, ss: 128 sss: 32 
0xbc8f15f43209dd0a00c79dfaa07c26c93bd16dec, 1991, 158, 145, 13, 0, 158, 0, 0, 1.0, 25266, ss: 128 sss: 32 
0xf649a1733b46cfdaaaeced8f046fa0782b66e5d8, 1932, 173, 165, 8, 0, 173, 0, 0, 1.0, 37370, ss: 128 sss: 32 
0x9ac5ed285f901d1689a74aac5716ab376e563b0c, 1550, 135, 133, 2, 0, 135, 0, 0, 1.0, 42224, ss: 128 sss: 32 
0x6fadf99da67e6c999241b0554d873d6cfc36c228, 1506, 107, 106, 1, 0, 107, 0, 0, 1.0, 28532, ss: 128 sss: 32 
0x9d6b95bb40055bdaec95d81cb6f614aa98d01332, 1599, 111, 109, 2, 0, 111, 0, 0, 1.0, 38299, ss: 128 sss: 32 
0xe5C9e4097cb26CA0dbF615c1113d9BE1aa7B50B9, 882, 54, 49, 5, 0, 54, 0, 0, 1.0, 394, ss: 128 sss: 32 
0xdfca58ebbf5d4977ea1e8ee200e7eb0dd0670ef1, 1585, 108, 107, 1, 0, 108, 0, 0, 1.0, 52322, ss: 128 sss: 32 
0x212cC97232290f43C113E6dD9AF901d55cEc819a, 2848, 245, 227, 18, 0, 245, 0, 0, 1.0, 93032, ss: 128 sss: 32 
0xba630A7457f110211d9543f5D2D59233e9E4754d, 1305, 98, 98, 0, 0, 98, 0, 0, 1.0, 32875, ss: 128 sss: 32 
0xd8c56ae718aa335cce11292add0198b880aa1954, 1512, 107, 106, 1, 0, 107, 0, 0, 1.0, 58779, ss: 128 sss: 32 
0x09cbe5a551a1a7b5f51c123568b5e667c84659a1, 1617, 115, 114, 1, 0, 115, 0, 0, 1.0, 54590, ss: 128 sss: 32 
0xa8c084083a5be2d5a2cc54c501adb88bb47a652a, 1515, 108, 106, 2, 0, 108, 0, 0, 1.0, 56911, ss: 128 sss: 32 
0x790620365a9abe11170a1978c676e98c98aeeb9c, 1516, 107, 106, 1, 0, 107, 0, 0, 1.0, 68511, ss: 128 sss: 32 
0x352af70cdae5bd9772b823f96310c4d0a801f27e, 1483, 103, 103, 0, 0, 103, 0, 0, 1.0, 49280, ss: 128 sss: 32 
0x8b42012324157ef46b7cf401364a89eeb28d6fb5, 1499, 103, 103, 0, 0, 103, 0, 0, 1.0, 38925, ss: 128 sss: 32 
0xf38db58994ead8c00ee4c7b1ce5b1972263bdeb7, 1009, 85, 81, 4, 0, 85, 0, 0, 1.0, 37827, ss: 128 sss: 32 
0xaf4c6752feff6572615445ae4d2335abde418df1, 1614, 110, 109, 1, 0, 110, 0, 0, 1.0, 21668, ss: 128 sss: 32 
0x41142dd49c3f93991e3ac163451dbf44c1906e10, 1524, 107, 106, 1, 0, 107, 0, 0, 1.0, 52727, ss: 128 sss: 32 
0xacc819d42b5be307e5dc801ceee0035fd0a83414, 2613, 182, 176, 6, 0, 182, 0, 0, 1.0, 40422, ss: 128 sss: 32 
0xd20028505d153227936a588d11846b07f53e7ec7, 1356, 96, 95, 1, 0, 96, 0, 0, 1.0, 21412, ss: 128 sss: 32 
0xA99470269d47B0Fbb202Dc2C66D49d2be2a345F7, 2926, 273, 256, 17, 0, 273, 0, 0, 1.0, 95347, ss: 128 sss: 32 
0x1a74f17872759397b673d7b5fc083eb6a7f496a8, 1531, 107, 106, 1, 0, 107, 0, 0, 1.0, 34011, ss: 128 sss: 32 
0x264e19416598861ac02814981d8aae7e13274b2c, 1506, 107, 106, 1, 0, 107, 0, 0, 1.0, 72309, ss: 128 sss: 32 
0xda1266b512baecfed27b5bfa47f403da9507628b, 1579, 103, 103, 0, 0, 103, 0, 0, 1.0, 40944, ss: 128 sss: 32 
0x826f1a1c427b32fa32c449df12b815f88dc55dc8, 1008, 84, 81, 3, 0, 84, 0, 0, 1.0, 30181, ss: 128 sss: 32 
0x3ff20e394ddb252c9b295d503b931dbbfae314c5, 1665, 121, 119, 2, 0, 121, 0, 0, 1.0, 36246, ss: 128 sss: 32 
0x2b39dc9771646ed358168e09572eeb238cc78574, 2838, 282, 263, 19, 0, 282, 0, 0, 1.0, 68961, ss: 128 sss: 32 
0xc07B98E009e6951BC67cc6470A1728df9d38A096, 2955, 269, 251, 18, 0, 269, 0, 0, 1.0, 84376, ss: 128 sss: 32 
0xF4c35D3cDF4AB68E67A0dF7429b4E07c92a0bD37, 1787, 118, 115, 3, 0, 118, 0, 0, 1.0, 66008, ss: 128 sss: 32 
0xfcd5b675ae8e9dd0172c84568b6ef504e1dc8619, 1527, 107, 106, 1, 0, 107, 0, 0, 1.0, 70600, ss: 128 sss: 32 
0x67533C926BB68b260993d0E4246CDa2A9A14448c, 2958, 275, 262, 13, 0, 275, 0, 0, 1.0, 82221, ss: 128 sss: 32 
0xaf329E311630AFFcb81fDE1aDF0527E421686bA6, 2940, 273, 256, 17, 0, 273, 0, 0, 1.0, 78432, ss: 128 sss: 32 
0xf9067258b7b4d70eb9307c009be32916acc4edc4, 1525, 107, 106, 1, 0, 107, 0, 0, 1.0, 32324, ss: 128 sss: 32 
0x12ea85e7778ecb0fb2bd3cb404a6341642eab092, 2995, 298, 287, 11, 0, 298, 0, 0, 1.0, 59272, ss: 128 sss: 32 
0x5c3596cedb2396d9fe88171decbeda5eebf0c5a9, 1263, 98, 98, 0, 0, 98, 0, 0, 1.0, 17789, ss: 128 sss: 32 
0x1cfe1d4C863f7832a1A5c2ACb43dFf08F74d680c, 1273, 102, 100, 2, 0, 102, 0, 0, 1.0, 20479, ss: 128 sss: 32 
0xe99fcd9396dbc294055350267b8257e9b05f01ac, 1515, 108, 106, 2, 0, 108, 0, 0, 1.0, 72735, ss: 128 sss: 32 
0xdf14Acd8a2661427a4b17b36A51F1199a02C63a2, 2954, 275, 262, 13, 0, 275, 0, 0, 1.0, 69364, ss: 128 sss: 32 
0x3d0c6aff559ada6bfaa911b092e6c2ae4eb5505b, 1352, 81, 80, 1, 0, 81, 0, 0, 1.0, 7398, ss: 128 sss: 32 
0x790888d358963e0dd6ad3036cf40db2297f4d5f8, 1583, 108, 108, 0, 0, 108, 0, 0, 1.0, 54461, ss: 128 sss: 32 
0x2240b35dbbaf407a463b5d40221d2ab1e19d9a19, 1509, 107, 106, 1, 0, 107, 0, 0, 1.0, 55652, ss: 128 sss: 32 
0x2c25d88e6dea171a32d15893e975409046c806b7, 1014, 84, 81, 3, 0, 84, 0, 0, 1.0, 20589, ss: 128 sss: 32 
0x81538c473291864419bfbf565c674c9d1f26ce1d, 1285, 98, 98, 0, 0, 98, 0, 0, 1.0, 23848, ss: 128 sss: 32 
0x8d32c9C39D9Aac5FFCbE9139FD8Ba648Af92d070, 2967, 229, 228, 1, 0, 229, 0, 0, 1.0, 105628, ss: 128 sss: 32 
0x11fbf29e443466dc714362dbdf95694b74727dc2, 2128, 195, 183, 12, 0, 195, 0, 0, 1.0, 41351, ss: 128 sss: 32 
0x89682e5F9bf69C909FC5E21a06495ac35E3671Ab, 2414, 175, 172, 3, 0, 175, 0, 0, 1.0, 29222, ss: 128 sss: 32 
0x3877b375050BC9FFcCaB9b6764880F0d3aca87B3, 2945, 275, 262, 13, 0, 275, 0, 0, 1.0, 127110, ss: 128 sss: 32 
0xffb83d339b71588dc616d77a0e3493e122bde73f, 1918, 171, 159, 12, 0, 171, 0, 0, 1.0, 57707, ss: 128 sss: 32 
0xEF75e83633E686D3085b3a988b937D021e2fA628, 2203, 151, 147, 4, 0, 151, 0, 0, 1.0, 25493, ss: 128 sss: 32 
0x325b549a92ffcaaa5dc90a77bc8b37c69268a1e9, 1764, 175, 172, 3, 0, 175, 0, 0, 1.0, 74615, ss: 128 sss: 32 
0x2346cbcba632847b9786f153cacc4f307508a78b, 1508, 107, 106, 1, 0, 107, 0, 0, 1.0, 35560, ss: 128 sss: 32 
0x8bcb530bcba57ed9889f29afb58772a28183f227, 1816, 94, 89, 5, 0, 94, 0, 0, 1.0, 10679, ss: 128 sss: 32 
0x82ab67ad6fb9a08304c0628614b9e3ebe0771054, 1598, 110, 110, 0, 0, 110, 0, 0, 1.0, 34892, ss: 128 sss: 32 
0x960b068dbaf5348d1303e8ac51f56636e481146f, 636, 53, 53, 0, 0, 53, 0, 0, 1.0, 8905, ss: 128 sss: 32 
0xcccce6a0eeccf30cc2a822d86d818348f62dfbc8, 1609, 110, 109, 1, 0, 110, 0, 0, 1.0, 47145, ss: 128 sss: 32 
0xeebda70301072c222fcd5aa22fceded6a2d80ced, 1474, 116, 115, 1, 0, 116, 0, 0, 1.0, 32414, ss: 128 sss: 32 
0x1e86fb3e9d2d93ab183091480c62c80cff96d0c2, 2935, 263, 248, 15, 0, 263, 0, 0, 1.0, 74584, ss: 128 sss: 32 
0xc7d4a00e7a97eef4299f2c32f7c3df20d9be3895, 1870, 126, 122, 4, 0, 126, 0, 0, 1.0, 25767, ss: 128 sss: 32 
0xac27420bb5d8b90d790e69223c3a22387f4f41dc, 1524, 108, 106, 2, 0, 108, 0, 0, 1.0, 41518, ss: 128 sss: 32 
0x6C0C323c53F56AE951DE0F5De9f99D916C72d88c, 2396, 219, 194, 25, 0, 219, 0, 0, 1.0, 19252, ss: 128 sss: 32 
0x76b23dbbc43cf6e03a1360480e18faaff220bcd5, 1525, 107, 106, 1, 0, 107, 0, 0, 1.0, 35151, ss: 128 sss: 32 
0xdcf2e183adfb455053817b3c26745b51f72aa960, 2255, 199, 183, 16, 0, 199, 0, 0, 1.0, 64300, ss: 128 sss: 32 
0x0557e881c4148f8ffb7c35c695ab7a3644044029, 1516, 107, 106, 1, 0, 107, 0, 0, 1.0, 33374, ss: 128 sss: 32 
0xf9456dccf0c989aa449736368453db18017fa305, 1588, 109, 108, 1, 0, 109, 0, 0, 1.0, 74002, ss: 128 sss: 32 
0x07facddd50f4492f703d78e120b733c0c454d635, 2425, 226, 215, 11, 0, 226, 0, 0, 1.0, 83879, ss: 128 sss: 32 
0x9aacda3235c7688a24e7e5aea2f90664d5a0b728, 1527, 107, 106, 1, 0, 107, 0, 0, 1.0, 34939, ss: 128 sss: 32 
0x9aaa011ab1649e98c6ea58d9fb01c53b8175de21, 2010, 170, 160, 10, 0, 170, 0, 0, 1.0, 35952, ss: 128 sss: 32 
0xfefc95aA8309fb9dF3d7084efE831C4BC9Bca580, 2341, 205, 195, 10, 0, 205, 0, 0, 1.0, 105239, ss: 128 sss: 32 
0xc760b9FD3131a80131C2D79BcaB7E3A589063169, 186, 8, 6, 2, 0, 8, 0, 0, 1.0, 16, ss: 128 sss: 32 
0x0C7052C94c0B3D39c2CEbEACBb6aFa9892e49D1C, 2874, 259, 253, 6, 0, 259, 0, 0, 1.0, 57012, ss: 128 sss: 32 
0xF5d11D19AF9B335d1291BB072D6Aa28b6648a21E, 1928, 170, 161, 9, 0, 170, 0, 0, 1.0, 64127, ss: 128 sss: 32 
0xe595236358c66F3407A881c62eB32F31b2D6b545, 2950, 275, 262, 13, 0, 275, 0, 0, 1.0, 107927, ss: 128 sss: 32 
0x1a9e7a59b01fe4793b1d9b1c3ca8922ecee4d0c7, 1508, 107, 106, 1, 0, 107, 0, 0, 1.0, 35155, ss: 128 sss: 32 
0xb1ab9165d4e6ac613f3c1f880ee9fb4c3aaf90fe, 2807, 195, 187, 8, 0, 195, 0, 0, 1.0, 29446, ss: 128 sss: 32 
0xf367f3694231ffe9ccbb4c54b1047a91df815a63, 1004, 84, 81, 3, 0, 84, 0, 0, 1.0, 31443, ss: 128 sss: 32 
0xbf34446bc5a62a72c4d68fda4189aff6efb6d3be, 2411, 190, 182, 8, 0, 190, 0, 0, 1.0, 58509, ss: 128 sss: 32 
0x98a29989b84b479e032e3cb696effee951ed2094, 1517, 107, 106, 1, 0, 107, 0, 0, 1.0, 31263, ss: 128 sss: 32 
0xfbd2ad20e3a1d2afdbf92c269d0f219223e16aa5, 1196, 99, 95, 4, 0, 99, 0, 0, 1.0, 8456, ss: 128 sss: 32 
0x156633c9cb90101465dc832153fdc72976100408, 1516, 107, 106, 1, 0, 107, 0, 0, 1.0, 69925, ss: 128 sss: 32 
0x3885ba79c4d9422ac02999b5513ff3837d2e6eb1, 1517, 107, 106, 1, 0, 107, 0, 0, 1.0, 66556, ss: 128 sss: 32 
0x0000000000004250039d1cf730bdd00b31942d18, 1481, 95, 94, 1, 0, 95, 0, 0, 1.0, 4794, ss: 128 sss: 32 
0xf720f4c2841b23cfb0058276a29a93c8b0650658, 1509, 107, 106, 1, 0, 107, 0, 0, 1.0, 55169, ss: 128 sss: 32 
0xa24d3886be3557782eeffb5f6ac6a4bb24faff55, 1574, 107, 106, 1, 0, 107, 0, 0, 1.0, 46934, ss: 128 sss: 32 
0xba4aec451ccd4cec1664c1ad9fe06af219a0e18c, 1221, 120, 119, 1, 0, 120, 0, 0, 1.0, 16321, ss: 128 sss: 32 
0x467bd22a7eca900bca2a21ab34acac87c3de8c8b, 1624, 116, 114, 2, 0, 116, 0, 0, 1.0, 60080, ss: 128 sss: 32 
0x9e56f29457da741c64a7c45cea979a18fcd8f1c7, 1636, 114, 112, 2, 0, 114, 0, 0, 1.0, 11699, ss: 128 sss: 32 
0x77278b34008E1E1f250634068666c4bdA3f22e06, 2840, 245, 227, 18, 0, 245, 0, 0, 1.0, 65014, ss: 128 sss: 32 
0x554e50d9fffb10dc697200bf2cf5dcdf623b872e, 1526, 107, 106, 1, 0, 107, 0, 0, 1.0, 34259, ss: 128 sss: 32 
0xa9eb5c18e4f2ae4a5a5130d5356abc44cf55004d, 2776, 216, 205, 11, 0, 216, 0, 0, 1.0, 29962, ss: 128 sss: 32 
0xf77c1af719f7e03b031313226b6fde053c4b3d7a, 2647, 257, 236, 21, 0, 257, 0, 0, 1.0, 92351, ss: 128 sss: 32 
0x7815b560979F112321676dfBF95CFaf978Af45a4, 1816, 89, 89, 0, 0, 89, 0, 0, 1.0, 5714, ss: 128 sss: 32 
0x0a8e40eff1220f5be5a33709549735d1bc67eb3f, 2418, 178, 175, 3, 0, 178, 0, 0, 1.0, 83129, ss: 128 sss: 32 
0x193B1B260EDb120b9CF5F4964d6Eac9231340ae6, 2640, 228, 208, 20, 0, 228, 0, 0, 1.0, 86805, ss: 128 sss: 32 
0x85d21114cd497af5f12c168dadd9a27f39661f4f, 1622, 115, 114, 1, 0, 115, 0, 0, 1.0, 58104, ss: 128 sss: 32 
0x9d9ed0d05b17e4261cd2c1a8ed418c1000c44b17, 1578, 110, 110, 0, 0, 110, 0, 0, 1.0, 34022, ss: 128 sss: 32 
0xa234eadd203b082068c5262e0e8c8e94acaa23b2, 1369, 96, 95, 1, 0, 96, 0, 0, 1.0, 33524, ss: 128 sss: 32 
0x0e5425cd1ea6726b051dea821d9c5a7c0d09b063, 1509, 107, 106, 1, 0, 107, 0, 0, 1.0, 37491, ss: 128 sss: 32 
0x81401e613cac201dcba966d52b305ea2c36c476b, 1475, 116, 115, 1, 0, 116, 0, 0, 1.0, 26151, ss: 128 sss: 32 
0x0308ed49ca72f54474324de71fbdc6023fa9ed82, 1916, 148, 147, 1, 0, 148, 0, 0, 1.0, 48663, ss: 128 sss: 32 
0x8c13581ad0473869e0833a65d67b3912de1017ff, 1514, 110, 110, 0, 0, 110, 0, 0, 1.0, 40547, ss: 128 sss: 32 
0x3fF413C167A4e81Aaa16E0318DC599A95a232492, 2942, 273, 256, 17, 0, 273, 0, 0, 1.0, 77174, ss: 128 sss: 32 
0x32502D0297e2080329fEc45c5D11aE393b8E6863, 2934, 273, 256, 17, 0, 273, 0, 0, 1.0, 62883, ss: 128 sss: 32 
0xbcd4649ab2f0a64cea0240b29a7ca0e95833ad42, 1630, 116, 114, 2, 0, 116, 0, 0, 1.0, 62920, ss: 128 sss: 32 
0x11839659D673C6c3D27E0f8E54Fd3370bD872F87, 2159, 139, 136, 3, 0, 139, 0, 0, 1.0, 32658, ss: 128 sss: 32 
0xb6fca2e2837b87060b30672da71e1bbec0dc774b, 2798, 239, 227, 12, 0, 239, 0, 1, 1.0, 25649, ss: 128 sss: 32 
0x428d9589041734a48761b03898142052b2a69cf6, 1342, 94, 92, 2, 0, 94, 0, 0, 1.0, 18249, ss: 128 sss: 32 
0xdb4ab249d09c1cb949c4ff0374f0d1e50ad1face, 1202, 86, 84, 2, 0, 86, 0, 0, 1.0, 18167, ss: 128 sss: 32 
0x1edc5c6a361d9c4b5656a4f4a60ec8515aed4998, 1792, 140, 137, 3, 0, 140, 0, 0, 1.0, 21673, ss: 128 sss: 32 
0x3742fcd7c6b15d72613920c6d3672f7b41f95119, 2848, 247, 234, 13, 0, 247, 0, 0, 1.0, 72652, ss: 128 sss: 32 
0x434B1fA331F6aFfb83FB0a6af3cB1Ac7CB792e1E, 2947, 275, 262, 13, 0, 275, 0, 0, 1.0, 72404, ss: 128 sss: 32 
0xfe6e9e19fea5e5d2da10cbe029a90e7380337920, 1510, 107, 106, 1, 0, 107, 0, 0, 1.0, 40737, ss: 128 sss: 32 
0x3c7eda0f9fe481a77507466dc42352ec64be4ea1, 1707, 102, 100, 2, 0, 102, 0, 0, 1.0, 56598, ss: 128 sss: 32 
0x9983ff02d5d85ce3da32e563dc9deab799067a75, 1224, 87, 87, 0, 0, 87, 0, 0, 1.0, 18766, ss: 128 sss: 32 
0x117ac3dbec52861a463c3c3e7660caab30123629, 2722, 243, 206, 37, 0, 243, 0, 0, 1.0, 31432, ss: 128 sss: 32 
0x6e98f381b7715c332e819d0e852bfa57e134608d, 1583, 108, 106, 2, 0, 108, 0, 0, 1.0, 42996, ss: 128 sss: 32 
0x1554f1be6a2277f720ef1b23da9f7d89f1b1a15a, 2962, 275, 262, 13, 0, 275, 0, 0, 1.0, 90603, ss: 128 sss: 32 
0x99d0947aa396f305071f357fc74998740e5c1a81, 1588, 108, 108, 0, 0, 108, 0, 0, 1.0, 60033, ss: 128 sss: 32 
0x6617f50bd993f86045cfdf99e579bf9d7225125f, 1488, 103, 103, 0, 0, 103, 0, 0, 1.0, 37602, ss: 128 sss: 32 
0xf50e161958c16f450cfc62549cb8ca44c3fb4291, 1588, 108, 108, 0, 0, 108, 0, 0, 1.0, 30483, ss: 128 sss: 32 
0xe7ffa77b74cfb68b7aa45ac94f9b1baacbce850c, 1236, 87, 87, 0, 0, 87, 0, 0, 1.0, 14524, ss: 128 sss: 32 
0x66619dfca339c43b22e8aa429e5c477e6fd65ab1, 2793, 223, 219, 4, 0, 223, 0, 0, 1.0, 41660, ss: 128 sss: 32 
0x1f82e695ef98caf7860d895cd55d89bd839cfb69, 1519, 107, 106, 1, 0, 107, 0, 0, 1.0, 51021, ss: 128 sss: 32 
0x6ca23e5b934f8fd069edb1e2690ccece50069752, 1508, 107, 106, 1, 0, 107, 0, 0, 1.0, 35790, ss: 128 sss: 32 
0xdda11549d2F4e3a94C1f9319b22aC0d83A733bDb, 2308, 203, 193, 10, 0, 203, 0, 0, 1.0, 80515, ss: 128 sss: 32 
0x5984c1185c4dc7dbcc207d9f7499014ac53e0b04, 2428, 179, 178, 1, 0, 179, 0, 0, 1.0, 57792, ss: 128 sss: 32 
0x059738e331cb84ea87f3eaec6e37d1c00f4a7847, 1306, 106, 105, 1, 0, 106, 0, 0, 1.0, 27138, ss: 128 sss: 32 
0x199454dd93607a4a13a9b3395dec3b797ef08c7c, 1516, 107, 106, 1, 0, 107, 0, 0, 1.0, 57063, ss: 128 sss: 32 
0x3fac10e640b8d3e9c2839f66b2ee3f26372f8b78, 1806, 140, 134, 6, 0, 140, 0, 0, 1.0, 14273, ss: 128 sss: 32 
0x0ed0881280ca6141974c9604b75d994c6fd92ef8, 1273, 98, 98, 0, 0, 98, 0, 0, 1.0, 30656, ss: 128 sss: 32 
0xbc30a376BF142E578E07d048eb2E9579F3AA4480, 2310, 220, 209, 11, 0, 220, 0, 0, 1.0, 108438, ss: 128 sss: 32 
0xd3fd7978e7786179f5b0386d60119097701ff42d, 1040, 108, 107, 1, 0, 108, 0, 0, 1.0, 18121, ss: 128 sss: 32 
0x1acc8a8a5fac6a4c2d778ce32ff02a55b05a9b20, 2389, 221, 206, 15, 0, 221, 0, 0, 1.0, 78347, ss: 128 sss: 32 
0xacc309355c03205ab1bf6d84baa06b36f334d398, 1507, 107, 106, 1, 0, 107, 0, 0, 1.0, 56420, ss: 128 sss: 32 
0xE81010924cC13E2dE520ef38412DB1AAc7EdEb57, 2932, 273, 256, 17, 0, 273, 0, 0, 1.0, 66806, ss: 128 sss: 32 
0xc972f6d048c2fe487cc98443e04499f6b57fd990, 1510, 107, 106, 1, 0, 107, 0, 0, 1.0, 39309, ss: 128 sss: 32 
0x2c2739034a3F8f229029aFEC0FA62345753e69BB, 1711, 135, 135, 0, 0, 135, 0, 0, 1.0, 52186, ss: 128 sss: 32 
0x41947ac8bee1ce07dc12681cce7af81a55241d69, 2895, 278, 270, 8, 0, 278, 0, 0, 1.0, 129362, ss: 128 sss: 32 
0x3bddcbc21ef7154cd2ea4f5b494718f1db19a9fb, 1632, 114, 113, 1, 0, 114, 0, 0, 1.0, 42046, ss: 128 sss: 32 
0xfc3ed9828f3ae99d19730a04a83bb92f6738b71e, 1518, 107, 106, 1, 0, 107, 0, 0, 1.0, 68667, ss: 128 sss: 32 
0x29f4854db26ed2828ba3f16513fd20fda736d06a, 1482, 109, 107, 2, 0, 109, 0, 0, 1.0, 28074, ss: 128 sss: 32 
0xDF66A972F76473a2793246fBe881F470F9cBD379, 2986, 279, 256, 23, 0, 279, 0, 0, 1.0, 55570, ss: 128 sss: 32 
0x78aeae02e7215aa80708313e4fcca6a5839075ca, 1513, 107, 106, 1, 0, 107, 0, 0, 1.0, 58205, ss: 128 sss: 32 
0x5d5bb5bdb7a228fd2f0f90c5ec7e5bc609529821, 1534, 107, 106, 1, 0, 107, 0, 0, 1.0, 74758, ss: 128 sss: 32 
0xaee45d771e173506456e20fbdec12de9afdd593f, 1609, 110, 109, 1, 0, 110, 0, 0, 1.0, 22207, ss: 128 sss: 32 
0x72899247617201e4d7d6a7d78162671147292b93, 1955, 141, 140, 1, 0, 141, 0, 0, 1.0, 18709, ss: 128 sss: 32 
0x89f01f62bd8b5f1a24242509f95f77407cd77e8d, 1509, 107, 106, 1, 0, 107, 0, 0, 1.0, 39861, ss: 128 sss: 32 
0x80bfb44a35df959334c3fe483ce67d9fd7af603e, 1509, 107, 106, 1, 0, 107, 0, 0, 1.0, 33272, ss: 128 sss: 32 
0x982fc8dec56b8419fe4996782354324bf74bbd9d, 1524, 107, 106, 1, 0, 107, 0, 0, 1.0, 71892, ss: 128 sss: 32 
0x86b939Ff9bb3cC5Cd9c7B57D298D6D20B4c7Bb56, 1427, 87, 87, 0, 0, 87, 0, 0, 1.0, 991, ss: 128 sss: 32 
0x37b4368ce10083CE555B28c31e11c7B94C00c700, 2867, 247, 234, 13, 0, 247, 0, 0, 1.0, 141154, ss: 128 sss: 32 
0xf4fef7faba1714f1424691e1a928047e11744194, 1513, 107, 106, 1, 0, 107, 0, 0, 1.0, 30311, ss: 128 sss: 32 
0x08ce3689092e2200aab6ce0e46084dfa88c3ad56, 1507, 107, 106, 1, 0, 107, 0, 0, 1.0, 37950, ss: 128 sss: 32 
0x03ecf73968d146a24e51c2ac5f79389ad5801e64, 1506, 110, 110, 0, 0, 110, 0, 0, 1.0, 30474, ss: 128 sss: 32 
0x0b4d5eb4f4e0bef020ecd0c25ae8a6e03a220769, 2853, 247, 234, 13, 0, 247, 0, 0, 1.0, 103154, ss: 128 sss: 32 
0x1e4d2b778138eb89def080071c427ba0f203b0ac, 1014, 84, 81, 3, 0, 84, 0, 0, 1.0, 33002, ss: 128 sss: 32 
0x1a0205cd3fa5b3d8a11444a14b6c0fc993c2dc14, 1578, 108, 108, 0, 0, 108, 0, 0, 1.0, 65401, ss: 128 sss: 32 
0xaa89568540a083776292ae5d1f838cf28c798f5e, 1486, 103, 103, 0, 0, 103, 0, 0, 1.0, 32762, ss: 128 sss: 32 
0x4074e0c6bd91d27fe48dbec3719a5cd7930505a9, 1605, 110, 109, 1, 0, 110, 0, 0, 1.0, 21494, ss: 128 sss: 32 
0x432ea2fb2154a5369ec8f6d2a4eadffdab55ebf2, 1525, 115, 114, 1, 0, 115, 0, 0, 1.0, 32478, ss: 128 sss: 32 
0x9bD6fb872fD67d764b96c87F009a1b14D8F74CfD, 2961, 275, 262, 13, 0, 275, 0, 0, 1.0, 101208, ss: 128 sss: 32 
0xf0101ab35ccdb6869cac409e8653046e4b14bc80, 1506, 111, 110, 1, 0, 111, 0, 0, 1.0, 26871, ss: 128 sss: 32 
0x5371416b6cbee8710e2832728b31ce743856b30b, 1584, 107, 106, 1, 0, 107, 0, 0, 1.0, 36918, ss: 128 sss: 32 
0x202417328d8D954119aDd889F4364d0b372989Df, 2863, 247, 233, 14, 0, 247, 0, 0, 1.0, 105402, ss: 128 sss: 32 
0x317649779b7ca2fa139c79c3628e11da92d6a91b, 1529, 115, 114, 1, 0, 115, 0, 0, 1.0, 46380, ss: 128 sss: 32 
0xccf562d5dd002746642c16ca82efe6045576aff7, 1312, 90, 89, 1, 0, 90, 0, 0, 1.0, 37897, ss: 128 sss: 32 
0xe3e5a82cc4944e17840930eace19146712253842, 1486, 117, 115, 2, 0, 117, 0, 0, 1.0, 25717, ss: 128 sss: 32 
0x3a322f056651908E706665C55589906E509Ce0E0, 2162, 185, 169, 16, 0, 185, 0, 0, 1.0, 49157, ss: 128 sss: 32 
0x2493a571f6e6c116ef4ba5092706e299f2367105, 1516, 107, 106, 1, 0, 107, 0, 0, 1.0, 71186, ss: 128 sss: 32 
0x5de11cbc26705AA30853526F809EC18dBe55aD5b, 1237, 92, 92, 0, 0, 92, 0, 0, 1.0, 24805, ss: 128 sss: 32 
0x1a109df5ab4ddaafa7cd6d8ddae7bb256a31d3f5, 1526, 107, 106, 1, 0, 107, 0, 0, 1.0, 52104, ss: 128 sss: 32 
0x693824a22bcec4136c731072c2c8a151fa56f1d1, 1513, 107, 106, 1, 0, 107, 0, 0, 1.0, 39003, ss: 128 sss: 32 
0x4502e675bda0a3e86eb7dc2ed5cb7c9465aa6ea8, 1636, 115, 114, 1, 0, 115, 0, 0, 1.0, 48743, ss: 128 sss: 32 
0x55ef8892069771469eff5b478af498d482a741d1, 1615, 115, 114, 1, 0, 115, 0, 0, 1.0, 24735, ss: 128 sss: 32 
0xff0c0026aF44BAA9D7D60Abf1d7104833688Ac0e, 2333, 205, 195, 10, 0, 205, 0, 0, 1.0, 81140, ss: 128 sss: 32 
0xd15314257404ae4b32b70f39a883db52e57e40c8, 1907, 147, 147, 0, 0, 147, 0, 0, 1.0, 25993, ss: 128 sss: 32 
0x173309760E2A703808bCde2f9bf07C92EC10bbc2, 2397, 225, 212, 13, 0, 225, 0, 0, 1.0, 33142, ss: 128 sss: 32 
0x27e0f8a528ee9509e7e01d2d7e87ec4c33eda8c7, 1527, 107, 106, 1, 0, 107, 0, 0, 1.0, 32601, ss: 128 sss: 32 
0x5ead618e4b55e34310908b647063b70416eac761, 998, 62, 62, 0, 0, 62, 0, 0, 1.0, 12613, ss: 128 sss: 32 
0x93bcef3816fcc54086701730e58a5524093d3e83, 1516, 107, 106, 1, 0, 107, 0, 0, 1.0, 32809, ss: 128 sss: 32 
0x8F18602AF63138fB598772410BFB2514746f61E0, 1641, 139, 138, 1, 0, 139, 0, 0, 1.0, 13936, ss: 128 sss: 32 
0xb5ac1b723961c1e7a05ddcfd16100fb6328275fd, 1521, 107, 106, 1, 0, 107, 0, 0, 1.0, 54499, ss: 128 sss: 32 
0xFF8173D341E210BBCdAcca3eC1Fc1dBD60E347DA, 2891, 228, 220, 8, 0, 228, 0, 0, 1.0, 59138, ss: 128 sss: 32 
0x0355950f91e36b1dcf42360b06486b4e0021351a, 1593, 108, 108, 0, 0, 108, 0, 0, 1.0, 57273, ss: 128 sss: 32 
0xb986289335b72d9079f95f2260cdabef6ae33962, 1514, 107, 106, 1, 0, 107, 0, 0, 1.0, 54397, ss: 128 sss: 32 
0x679a55c36155a6cbf86eac22e75e33fb704e2d6e, 544, 40, 40, 0, 0, 40, 0, 0, 1.0, 1421, ss: 128 sss: 32 
0x16279e6ef0b6ca373a01d6baad73f4dd5ddb6306, 2863, 247, 234, 13, 0, 247, 0, 0, 1.0, 67452, ss: 128 sss: 32 
0x2dc22e7e100b6c4f43a85dd090190f9a6896ef85, 2889, 279, 270, 9, 0, 279, 0, 0, 1.0, 56833, ss: 128 sss: 32 
0x6554f880840d4573a4c2Ea4ed3cC04d93B707994, 1210, 90, 89, 1, 0, 90, 0, 0, 1.0, 14633, ss: 128 sss: 32 
0xa2ee1272c4bea6d857b19714c499dbebb88c2ed6, 1514, 107, 106, 1, 0, 107, 0, 0, 1.0, 36184, ss: 128 sss: 32 
0xd252972316668b4961ee79f9b7155d80b6afd11e, 1508, 107, 106, 1, 0, 107, 0, 0, 1.0, 57749, ss: 128 sss: 32 
0xa8415289c2a35CEEBacd2684fd566079773f162e, 2946, 275, 262, 13, 0, 275, 0, 0, 1.0, 92665, ss: 128 sss: 32 
0x1945a4cf306a4244ea30f97f02420a5d242d44d4, 1511, 107, 106, 1, 0, 107, 0, 0, 1.0, 65139, ss: 128 sss: 32 
0x4d0c468424ac6fe96c0a45f5e01104edfeab89a2, 1202, 90, 89, 1, 0, 90, 0, 0, 1.0, 16023, ss: 128 sss: 32 
0xaad125dc73d60cf719bc7473a13882758036a889, 1364, 108, 107, 1, 0, 108, 0, 0, 1.0, 23676, ss: 128 sss: 32 
0x5be324cad48203b8346869466b45a4f884bb792a, 1503, 107, 106, 1, 0, 107, 0, 0, 1.0, 32444, ss: 128 sss: 32 
0xd153b128462d08b1beda69f35e000873a5d52251, 2765, 263, 245, 18, 0, 263, 0, 0, 1.0, 99402, ss: 128 sss: 32 
0x7be83abf5ce2b97c6666fc408ab7c9c7ff574b29, 1517, 107, 106, 1, 0, 107, 0, 0, 1.0, 55296, ss: 128 sss: 32 
0x025382d4266cca4689055bb08b73202ce24e9b12, 1905, 147, 147, 0, 0, 147, 0, 0, 1.0, 36902, ss: 128 sss: 32 
0xcba45c98fa8706d7245aec9709a4fe61ba880a21, 1515, 108, 106, 2, 0, 108, 0, 0, 1.0, 30200, ss: 128 sss: 32 
0xDfa35C97000dA4aCeE3eF7C0911e877f13158833, 2951, 275, 262, 13, 0, 275, 0, 0, 1.0, 127725, ss: 128 sss: 32 
0x81324d217089cee039e3b660d9265ffebbf534cd, 1629, 114, 112, 2, 0, 114, 0, 0, 1.0, 32381, ss: 128 sss: 32 
0x09adc04a7c8f98235fb66238dec1da7096632db7, 2140, 195, 183, 12, 0, 195, 0, 0, 1.0, 46822, ss: 128 sss: 32 
0xe743a92cf9ec592593055a6d4bf940c645db2e61, 1215, 92, 92, 0, 0, 92, 0, 0, 1.0, 26740, ss: 128 sss: 32 
0x77656409c5584e05fff0425b3396bf9e72ebf311, 2373, 221, 205, 16, 0, 221, 0, 0, 1.0, 76215, ss: 128 sss: 32 
0x0956b6c651bb211b2bccdaa14ca9f1db3ae879e9, 1011, 84, 81, 3, 0, 84, 0, 0, 1.0, 27432, ss: 128 sss: 32 
0x14408574e04c6769cbf24340e862f24cc84af6c3, 1875, 145, 144, 1, 0, 145, 0, 0, 1.0, 42914, ss: 128 sss: 32 
0x4789EbDc11309A4422D0b72F83c32854396f8f3C, 2890, 264, 237, 27, 0, 264, 0, 0, 1.0, 73177, ss: 128 sss: 32 
0x2bd6e4c0a276accf63dffd3de274f2559b9c4f45, 1518, 107, 106, 1, 0, 107, 0, 0, 1.0, 51644, ss: 128 sss: 32 
0xebcd1a41a587415e57f17181fcfbabd281883e6e, 1522, 107, 106, 1, 0, 107, 0, 0, 1.0, 35421, ss: 128 sss: 32 
0x77cC131E21e38fD8409a45046599f4c946091D34, 2862, 259, 253, 6, 0, 259, 0, 0, 1.0, 78191, ss: 128 sss: 32 
0xAb2D7080faa744759519BF20D8200a851d9B1E53, 2188, 143, 139, 4, 0, 143, 0, 0, 1.0, 30260, ss: 128 sss: 32 
0x92ec84992fb11cf0bbc9cb1242257144e41f33df, 1596, 111, 109, 2, 0, 111, 0, 0, 1.0, 26679, ss: 128 sss: 32 
0x04D5b8be12428B459cCD326761b7e0a6F7c769c4, 2950, 273, 256, 17, 0, 273, 0, 0, 1.0, 133347, ss: 128 sss: 32 
0x6705c9f03763d0b509c5d4aa5144963cb7641dd9, 901, 96, 95, 1, 0, 96, 0, 0, 1.0, 6593, ss: 128 sss: 32 
0x2a27d2d9edc5e8e402484db8f828a61657808669, 1517, 107, 106, 1, 0, 107, 0, 0, 1.0, 34499, ss: 128 sss: 32 
0xf6049bc2f0b698a182f79fa3e758252b9cf3e86e, 2606, 184, 178, 6, 0, 184, 0, 0, 1.0, 46864, ss: 128 sss: 32 
0x3e2b03a8990b229d33bbaa148821293eb6e10738, 245, 29, 26, 3, 0, 29, 0, 0, 1.0, 374, ss: 128 sss: 32 
0x3db3b827b303e401b98ec2e5e9eecad064d72cab, 423, 25, 23, 2, 0, 25, 0, 0, 1.0, 330, ss: 128 sss: 32 
0x5b348ec54c290683697f6a812ca1bfbb0e74c70d, 1514, 107, 106, 1, 0, 107, 0, 0, 1.0, 69246, ss: 128 sss: 32 
0x6d65b95c1d8d1ce1b26012801ab07231831f1377, 2443, 217, 197, 20, 0, 217, 0, 0, 1.0, 48975, ss: 128 sss: 32 
0x48f74a530118da208e8a3f58b371ac7feeae03a5, 2432, 227, 215, 12, 0, 227, 0, 0, 1.0, 79905, ss: 128 sss: 32 
0x6046de78051284e145a4db746e6af090fc3ded09, 1513, 108, 106, 2, 0, 108, 0, 0, 1.0, 33607, ss: 128 sss: 32 
0xF1dDE04c3fb8f21523C9aF006e1094A476AC366A, 2296, 174, 162, 12, 0, 174, 0, 0, 1.0, 38327, ss: 128 sss: 32 
0x1deabb12981c9b4000cd16c2c101d91e5f6f950b, 1752, 143, 140, 3, 0, 143, 0, 0, 1.0, 15890, ss: 128 sss: 32 
0xef3923d674b4f99e7b10acf7790bced32a6e51f2, 1524, 108, 106, 2, 0, 108, 0, 0, 1.0, 33949, ss: 128 sss: 32 
0xef2fed2e35ffc706d361f033b5748f130225ec16, 1517, 107, 106, 1, 0, 107, 0, 0, 1.0, 59318, ss: 128 sss: 32 
0x122d2fd11d5e53a384f84a9666f0b92160c5cff3, 1512, 107, 106, 1, 0, 107, 0, 0, 1.0, 34163, ss: 128 sss: 32 
0xA651332Bf73905c326bdA4549A59c05Aa3bF7DA0, 980, 71, 69, 2, 0, 71, 0, 0, 1.0, 193079, ss: 128 sss: 32 
0x2a8907a01bc0acf7414d758c1c3c18949864091d, 1373, 108, 107, 1, 0, 108, 0, 0, 1.0, 25641, ss: 128 sss: 32 
0x16da19dbbff11467abc3f4a2e705d7cb77643526, 1772, 137, 125, 12, 0, 137, 0, 1, 1.0, 3834, ss: 128 sss: 32 
0xf07db4d2633e98ce576af75d36b1b12e7526a3b9, 1654, 115, 112, 3, 0, 115, 0, 0, 1.0, 30889, ss: 128 sss: 32 
0x141b8e12aec941acf2f42d6e34207b9ebc8f4574, 1565, 111, 109, 2, 0, 111, 0, 0, 1.0, 10582, ss: 128 sss: 32 
0x30355fafcf42de36fa15c3fc52952429398b375d, 1527, 108, 106, 2, 0, 108, 0, 0, 1.0, 53077, ss: 128 sss: 32 
0x4e8ad57d1ed1ecb21d9a70d0f0635e7a7ac5753c, 2337, 162, 155, 7, 0, 162, 0, 0, 1.0, 70584, ss: 128 sss: 32 
0x3280037f01757b73d0612cb4792d840f01fdac09, 2465, 171, 163, 8, 0, 171, 0, 0, 1.0, 82397, ss: 128 sss: 32 
0x8c9357Ef90Acc438F261Fbb3cC323271466aCC78, 858, 81, 81, 0, 0, 81, 0, 0, 1.0, 27634, ss: 128 sss: 32 
0x5b12378d60b1b04eac8b5e507bbff8c187c41827, 2604, 184, 178, 6, 0, 184, 0, 0, 1.0, 46475, ss: 128 sss: 32 
0x28ff565b088a58ce9ad2b88a1865a844763f8ea9, 2788, 196, 194, 2, 0, 196, 0, 0, 1.0, 85310, ss: 128 sss: 32 
0x836beed5235b794fa38e86a9ad1680035f607b12, 2802, 252, 237, 15, 0, 252, 0, 0, 1.0, 41985, ss: 128 sss: 32 
0xb1db38ea0e48e19a2b95424f9dfb275952d711eb, 2929, 258, 235, 23, 0, 258, 0, 0, 1.0, 66437, ss: 128 sss: 32 
0x8806DcbDec120FA999Fc546A90BC122355BA3899, 1609, 154, 146, 8, 0, 154, 0, 0, 1.0, 19557, ss: 128 sss: 32 
0x176132d5e846b381103b66f0f00db24be3db2fff, 1641, 114, 112, 2, 0, 114, 0, 0, 1.0, 19587, ss: 128 sss: 32 
0xa8b17ac337d3ec667a337222668dbe007ddad858, 1531, 107, 106, 1, 0, 107, 0, 0, 1.0, 61908, ss: 128 sss: 32 
0x18514595840ab87c13463708799aa8a973e565f9, 1519, 107, 106, 1, 0, 107, 0, 0, 1.0, 32554, ss: 128 sss: 32 
0xc596947037572f1b514931a1fcec6909c6e909ff, 2036, 164, 158, 6, 0, 164, 0, 0, 1.0, 34905, ss: 128 sss: 32 
0x3053dc675b09530b815072e7940ecb5fd19bc8a6, 1396, 110, 110, 0, 0, 110, 0, 0, 1.0, 15196, ss: 128 sss: 32 
0x9456e90877d59ac294d60217bd38d271cbfc0356, 1587, 110, 110, 0, 0, 110, 0, 0, 1.0, 34897, ss: 128 sss: 32 
0x12a96f74642addb6a534a138ecb319e0b118787a, 2899, 278, 270, 8, 0, 278, 0, 0, 1.0, 113019, ss: 128 sss: 32 
0x26172d08f9c6637dc0fc87b9661a2d394f560d57, 1522, 115, 114, 1, 0, 115, 0, 0, 1.0, 29889, ss: 128 sss: 32 
0xd74bd64629e4d8bf72cc3ea26fa42a7b1bcbaddf, 1584, 107, 106, 1, 0, 107, 0, 0, 1.0, 40078, ss: 128 sss: 32 
0xeb45be9a80bfbaca1aa3e8c4a48d387c56f049f6, 2953, 263, 233, 30, 0, 263, 0, 0, 1.0, 65497, ss: 128 sss: 32 
0xd940fe889096a2ecb0af219d1a82f1ca44bd44f8, 1051, 117, 103, 14, 0, 117, 0, 0, 1.0, 3307, ss: 128 sss: 32 
0x0872945eB70B4d989DB0b9F2440a37534aDFe2BA, 2847, 245, 227, 18, 0, 245, 0, 0, 1.0, 134597, ss: 128 sss: 32 
0xc2bb7741d4689b111500273af1c70b0108fc1246, 2879, 248, 235, 13, 0, 248, 0, 0, 1.0, 126368, ss: 128 sss: 32 
0xdfbaaea75007853f7cfb744a115250ce77263e57, 1510, 107, 106, 1, 0, 107, 0, 0, 1.0, 56061, ss: 128 sss: 32 
0xa91894ee8c3568c47A31dfC13da914725B27D5cc, 2923, 273, 256, 17, 0, 273, 0, 0, 1.0, 73440, ss: 128 sss: 32 
0x722AFCba56DF772C802E796724D9961e2D1D4403, 2935, 273, 256, 17, 0, 273, 0, 0, 1.0, 123501, ss: 128 sss: 32 
0x0e9f63bfc5911c515ba11531407ccc85434b1601, 2568, 230, 211, 19, 0, 230, 0, 0, 1.0, 45183, ss: 128 sss: 32 
0x6fe62ff9140055fc8a8b5adfa302dbfdb4876858, 1605, 110, 109, 1, 0, 110, 0, 0, 1.0, 35226, ss: 128 sss: 32 
0xdb88b9b10c1490cafb2c4d359544a2ec405f2908, 2484, 240, 229, 11, 0, 240, 0, 0, 1.0, 55624, ss: 128 sss: 32 
0x90e25a72500afd34b5c88e8b4a9976ad8be92d14, 1584, 108, 108, 0, 0, 108, 0, 0, 1.0, 53957, ss: 128 sss: 32 
0xd077361b41bfaa2b7379a4f1cd0af2ee59984b9e, 1517, 107, 106, 1, 0, 107, 0, 0, 1.0, 57453, ss: 128 sss: 32 
0xfb002557aa47c8987a9d027f6dbe0755078d4eee, 2412, 206, 196, 10, 0, 206, 0, 0, 1.0, 41281, ss: 128 sss: 32 
0x97551410e4965c5fc9e6475a38e9007c2fb0e5c1, 1526, 107, 106, 1, 0, 107, 0, 0, 1.0, 31824, ss: 128 sss: 32 
0x901184c47defff50663ea102f9790315a5317adb, 1896, 147, 147, 0, 0, 147, 0, 0, 1.0, 35661, ss: 128 sss: 32 
0xa8ed3d016b308ab48ecee135222b9105e7661e92, 1613, 110, 109, 1, 0, 110, 0, 0, 1.0, 39596, ss: 128 sss: 32 
0xa39d937f681543e766f11fff8d3faf7b6e55e326, 2634, 231, 227, 4, 0, 231, 0, 0, 1.0, 61483, ss: 128 sss: 32 
0xF025e07aCF90F94587b998C7de83522435d92146, 1676, 166, 160, 6, 0, 166, 0, 0, 1.0, 36280, ss: 128 sss: 32 
0xa6e983730ed2b47b9893ced746d50af3595f2f56, 1512, 107, 106, 1, 0, 107, 0, 0, 1.0, 31244, ss: 128 sss: 32 
0x1597702672c81986b41a40e93beb13cabe5328d8, 1521, 107, 106, 1, 0, 107, 0, 0, 1.0, 71804, ss: 128 sss: 32 
0x78aba4c6e27a77dca1abc73321f0292aa49dba63, 1465, 108, 107, 1, 0, 108, 0, 0, 1.0, 31242, ss: 128 sss: 32 
0x0002fa5b2e2dcc7ed5f4b26d5cea14e44d187e03, 1815, 94, 89, 5, 0, 94, 0, 0, 1.0, 14288, ss: 128 sss: 32 
0x0f06ab9c16dbc88afd77dc9cfc95fc012dca36d7, 2152, 197, 189, 8, 0, 197, 0, 0, 1.0, 41229, ss: 128 sss: 32 
0x9a1ba1687c2759fe96bfacbfb5300458b7d726f0, 1512, 107, 106, 1, 0, 107, 0, 0, 1.0, 68876, ss: 128 sss: 32 
0x15d9d21936fa6b0a494556db58eb93e2edd267f0, 1220, 87, 87, 0, 0, 87, 0, 0, 1.0, 9015, ss: 128 sss: 32 
0xf428666660687afe87f040c4da45dd4c851bbbbf, 1510, 107, 106, 1, 0, 107, 0, 0, 1.0, 57477, ss: 128 sss: 32 
0xcb8326e6f689dac55c2a844b0c5af908921eda8e, 1511, 107, 106, 1, 0, 107, 0, 0, 1.0, 40487, ss: 128 sss: 32 
0x60f19fd1f15fc08a1ea27d407dae25c4e7937547, 641, 53, 53, 0, 0, 53, 0, 0, 1.0, 1229, ss: 128 sss: 32 
0xd52c687d5b3b3226940e40f93f22d95ef61af354, 1494, 108, 107, 1, 0, 108, 0, 0, 1.0, 37346, ss: 128 sss: 32 
0x9531695Be421C2A3B11D4eC926edF813498021fE, 2863, 220, 204, 16, 0, 220, 0, 0, 1.0, 39663, ss: 128 sss: 32 
0x1855445a92453eDbdaE8072d123645698Ac9D2fF, 1901, 150, 146, 4, 0, 150, 0, 0, 1.0, 50863, ss: 128 sss: 32 
0xDcfCcaf54CB8c7c30bb7959929AbA24bF136FF57, 2965, 275, 262, 13, 0, 275, 0, 0, 1.0, 143986, ss: 128 sss: 32 
0x05B109A401534f0Ec068B77ACD62Eb3DC04cd824, 2949, 275, 262, 13, 0, 275, 0, 0, 1.0, 96250, ss: 128 sss: 32 
0x6e3c0c047ef3c4d1f04bead6879b00577262d912, 2166, 197, 189, 8, 0, 197, 0, 0, 1.0, 39450, ss: 128 sss: 32 
0x2c7061c96f0a4525a1dc276090a32f15245e5216, 2292, 158, 154, 4, 0, 158, 0, 0, 1.0, 94778, ss: 128 sss: 32 
0x3446d9a92b0d1d8db12507e850c158828fae4d95, 720, 61, 61, 0, 0, 61, 0, 0, 1.0, 5834, ss: 128 sss: 32 
0x98ce663e6ccbe12fdc2397b2a8d1ed0352476f78, 608, 48, 48, 0, 0, 48, 0, 0, 1.0, 1098, ss: 128 sss: 32 
0x771c51d95fdd95735522a8e8bae695f518213067, 2165, 198, 189, 9, 0, 198, 0, 0, 1.0, 73304, ss: 128 sss: 32 
0xbf94380c0c4dac83582f3cedca97c97d4585b2d0, 1766, 140, 137, 3, 0, 140, 0, 0, 1.0, 47285, ss: 128 sss: 32 
0x680cd5854919ab3f9ec04447752e45d105538275, 1538, 107, 106, 1, 0, 107, 0, 0, 1.0, 65383, ss: 128 sss: 32 
0x3020dd869be4fc1c8be64415d94264785f6d991e, 1529, 107, 106, 1, 0, 107, 0, 0, 1.0, 37527, ss: 128 sss: 32 
0x39531da3a9161c239e503cddbd5671892fc7c9b4, 1510, 107, 106, 1, 0, 107, 0, 0, 1.0, 56171, ss: 128 sss: 32 
0x6a15545cdc78bd599aea0991d448e5ec051905b9, 1709, 141, 133, 8, 0, 141, 0, 0, 1.0, 32898, ss: 128 sss: 32 
0x3c9F53a0aef44A20A18f341E45a698Ba36f102A4, 2323, 187, 184, 3, 0, 187, 0, 0, 1.0, 26551, ss: 128 sss: 32 
0x79bdd9e19bd64aca0479f52404a9ee5009e96fdb, 1519, 107, 106, 1, 0, 107, 0, 0, 1.0, 52855, ss: 128 sss: 32 
0x35bFEdDa9f98e062A8341a465954b2E85E963C99, 2857, 259, 253, 6, 0, 259, 0, 0, 1.0, 60151, ss: 128 sss: 32 
0x10f7a8e3ad09a0faa8d89a590d6faf397fdc8712, 1506, 107, 106, 1, 0, 107, 0, 0, 1.0, 35450, ss: 128 sss: 32 
0x8033b7a876b3591d663209ac64c3ceaa3196df3a, 2158, 197, 189, 8, 0, 197, 0, 0, 1.0, 44379, ss: 128 sss: 32 
0xE67404C6E4f6Ab58ac1F92E6056379CD2F4AAc6A, 2049, 146, 145, 1, 0, 146, 0, 0, 1.0, 95802, ss: 128 sss: 32 
0xD99E8bA5259Dd2b8B9aBFE0eD78913ec60B8F898, 1080, 83, 81, 2, 0, 83, 0, 0, 1.0, 11651, ss: 128 sss: 32 
0x9b51a41bdcefa32293090f5e0cd8aee460fd7dc2, 1518, 107, 106, 1, 0, 107, 0, 0, 1.0, 34134, ss: 128 sss: 32 
0xC27EEc1c192500DaA517D491f673eD81008a8c0b, 2174, 170, 152, 18, 0, 170, 0, 1, 1.0, 29890, ss: 128 sss: 32 
0x0a2f5e480cd55fc0e1d8a8ddc61427719841a3be, 2052, 192, 179, 13, 0, 192, 0, 0, 1.0, 70578, ss: 128 sss: 32 
0xCFF3771b61B65d5FE94C0436095c9Fd26a5DAB91, 2953, 275, 262, 13, 0, 275, 0, 0, 1.0, 120395, ss: 128 sss: 32 
0x47ab12a580be8da893383162c64a90d210fa84d1, 1642, 114, 111, 3, 0, 114, 0, 0, 1.0, 19862, ss: 128 sss: 32 
0xd4f3d9b7f69aedbec9aaafb81d053765d9e1d0bd, 2909, 256, 248, 8, 0, 256, 0, 0, 1.0, 88319, ss: 128 sss: 32 
0x2795db1490a41cc384b46a48c57d7ff506f931cb, 1511, 107, 106, 1, 0, 107, 0, 0, 1.0, 60053, ss: 128 sss: 32 
0x5d551ffff320a7d52eca30df0af449bb5df8efc5, 2029, 150, 149, 1, 0, 150, 0, 0, 1.0, 85414, ss: 128 sss: 32 
0x29945530a18d08a79b893cbaf9911c52b716a5ed, 1884, 145, 144, 1, 0, 145, 0, 0, 1.0, 38669, ss: 128 sss: 32 
0x098008be8a62635979635babe85dafbae31f0f0a, 2402, 191, 182, 9, 0, 191, 0, 0, 1.0, 64253, ss: 128 sss: 32 
0x389e094598366324664c63c118fab4a844cad925, 1508, 107, 106, 1, 0, 107, 0, 0, 1.0, 42199, ss: 128 sss: 32 
0x22a0f462dfb26ab5c8dffdeb7553e1e81c091280, 1512, 107, 106, 1, 0, 107, 0, 0, 1.0, 37900, ss: 128 sss: 32 
0x4417265c6a4f2b041e5ccd2c9dfb30c819ea4df4, 1603, 109, 109, 0, 0, 109, 0, 0, 1.0, 38386, ss: 128 sss: 32 
0x4363a9f5330f8a34fd3c48653b36dd7d09bbb5aa, 1198, 90, 89, 1, 0, 90, 0, 0, 1.0, 20427, ss: 128 sss: 32 
0x3ada3bf9a5c5c59523d6193381c0d14787070e54, 1339, 107, 105, 2, 0, 107, 0, 0, 1.0, 43050, ss: 128 sss: 32 
0xa6c9976893eacb13688c16689ea183ce29004855, 1261, 92, 92, 0, 0, 92, 0, 0, 1.0, 120054, ss: 128 sss: 32 
0x3c436a86748ef2924c8c3adb04fcb6e676f35b28, 1506, 107, 106, 1, 0, 107, 0, 0, 1.0, 56501, ss: 128 sss: 32 
0x94d8e58c1fba2ff5081b2a077c4ba3230275baf2, 2654, 228, 208, 20, 0, 228, 0, 0, 1.0, 42763, ss: 128 sss: 32 
0x6B889CfBbF5e1ED06b96fa1bAC6F0D80462Ea151, 2162, 175, 173, 2, 0, 175, 0, 0, 1.0, 30008, ss: 128 sss: 32 
0x51dba9d808ef94b296bfe072c54832a990f3a9aa, 1509, 107, 106, 1, 0, 107, 0, 0, 1.0, 31278, ss: 128 sss: 32 
0x4582b79844e753ed53928d8b8761e9f27eb22735, 2562, 230, 211, 19, 0, 230, 0, 0, 1.0, 85860, ss: 128 sss: 32 
0x1e939f17149a576b70d332d189d39e27e2567b14, 2019, 168, 164, 4, 0, 168, 0, 0, 1.0, 33780, ss: 128 sss: 32 
0xc56e2085a6227637503086ef86b40ce4f358af97, 1522, 107, 106, 1, 0, 107, 0, 0, 1.0, 43402, ss: 128 sss: 32 
0xbE360D6D56F3504a7C2971a03BA34a3c6d67594F, 2190, 118, 114, 4, 0, 118, 0, 0, 1.0, 8975, ss: 128 sss: 32 
0xe8073e400e17186efd2911afa2310071c81f3d77, 2478, 170, 163, 7, 0, 170, 0, 0, 1.0, 46894, ss: 128 sss: 32 
0x96f297c5c2fb481889c0b0f5f4adec61911236c4, 2037, 151, 150, 1, 0, 151, 0, 0, 1.0, 39354, ss: 128 sss: 32 
0x3c862c59fa230df83b87f1ae742f2a6559f59fb0, 1587, 108, 108, 0, 0, 108, 0, 0, 1.0, 57709, ss: 128 sss: 32 
0xd523578e864b1e7741309e21cb29674a4f634807, 1221, 109, 109, 0, 0, 109, 0, 0, 1.0, 81383, ss: 128 sss: 32 
0x16eA5Db6A7C2A72749a7f7600CAA64c97468D50E, 783, 51, 48, 3, 0, 51, 0, 0, 1.0, 4540, ss: 128 sss: 32 
0x0D31EF21Fe03260C8953679D005f1aC76FD6199c, 2974, 275, 262, 13, 0, 275, 0, 0, 1.0, 110646, ss: 128 sss: 32 
0x5289701f1335ba95e48c58c998430004a0bbed32, 1352, 96, 95, 1, 0, 96, 0, 0, 1.0, 18727, ss: 128 sss: 32 
0x7576917e8ecaff11d64bcb30cd407f2f1cef2b64, 2836, 197, 189, 8, 0, 197, 0, 0, 1.0, 53965, ss: 128 sss: 32 
0xbd97c17573c8a37fa8ea53d1627fb43aee455225, 1523, 107, 106, 1, 0, 107, 0, 0, 1.0, 54175, ss: 128 sss: 32 
0x8fc2f002bc034d214c835ff687cbd458df331c99, 1527, 108, 106, 2, 0, 108, 0, 0, 1.0, 57665, ss: 128 sss: 32 
0xba2036dbda7284b3bda83be85f04b17c01a4ef53, 2436, 226, 215, 11, 0, 226, 0, 0, 1.0, 47127, ss: 128 sss: 32 
0x8A809c62bb3a6c1841daEb5aA2531358E45d803B, 1775, 117, 114, 3, 0, 117, 0, 0, 1.0, 42192, ss: 128 sss: 32 
0xea15fe16d39316130ad93ac0515f2432e8be3648, 1517, 127, 127, 0, 0, 127, 0, 0, 1.0, 19576, ss: 128 sss: 32 
0x0dcd1b77ef4459c37551b3a3fa4a8e1f2485ad08, 1504, 107, 106, 1, 0, 107, 0, 0, 1.0, 73667, ss: 128 sss: 32 
0xc0e5f5576bb8871a9c8eedf061990808cfaf3c10, 1530, 107, 106, 1, 0, 107, 0, 0, 1.0, 36156, ss: 128 sss: 32 
0x0000000000008dd2574908774527FD6DA397d75B, 525, 39, 38, 1, 0, 39, 0, 0, 1.0, 299, ss: 128 sss: 32 
0x63b0a86677df915812fdd3acff5ae7382f731d34, 2699, 193, 192, 1, 0, 193, 0, 0, 1.0, 63524, ss: 128 sss: 32 
0x68f0a129fa38173048c7bc355e819740a196eac5, 1520, 107, 106, 1, 0, 107, 0, 0, 1.0, 55347, ss: 128 sss: 32 
0xfba3f744caa9a25fcfef08d8596b79091682f774, 2574, 182, 175, 7, 0, 182, 0, 0, 1.0, 55575, ss: 128 sss: 32 
0x5041ab0a2f5010721cde0c6f163e9e053eb7ad31, 1428, 101, 100, 1, 0, 101, 0, 0, 1.0, 57074, ss: 128 sss: 32 
0xa801a49a37a09b2022b5d1f2222421a2f2d5656d, 1514, 110, 110, 0, 0, 110, 0, 0, 1.0, 25114, ss: 128 sss: 32 
0x1d93a8121c0279e94a8cb5301b2813191ee1071c, 1503, 107, 106, 1, 0, 107, 0, 0, 1.0, 56249, ss: 128 sss: 32 
0x6ca8937103a6a73025a9be86d4af90dabc019f0f, 1559, 103, 103, 0, 0, 103, 0, 0, 1.0, 27661, ss: 128 sss: 32 
0x04227C8fBd819777Ed5D0BdA0DED003Fe1e8aA30, 2928, 273, 256, 17, 0, 273, 0, 0, 1.0, 133760, ss: 128 sss: 32 
0xECc4457b322271f8615cA583789790e1a7b2e1af, 2522, 115, 110, 5, 0, 115, 0, 0, 1.0, 62341, ss: 128 sss: 32 
0xFAC1f633aa95bFEd35585814875227629fF441cC, 2024, 163, 156, 7, 0, 163, 0, 0, 1.0, 43152, ss: 128 sss: 32 
0x76aef5bfbde17cfbf3cd56c95065fedeadb0d65c, 1343, 94, 92, 2, 0, 94, 0, 0, 1.0, 29675, ss: 128 sss: 32 
0x91d2A8cecD2eCB93F137a4C5b7F16f3d36afC7dB, 1751, 142, 140, 2, 0, 142, 0, 0, 1.0, 66983, ss: 128 sss: 32 
0xe5cE54704f1B23de22b687eee628B32600ADC681, 2103, 124, 122, 2, 0, 124, 0, 0, 1.0, 65321, ss: 128 sss: 32 
0x9f88667f6e0d23bcbdf94d4c3e66379a6d2549b8, 1517, 107, 106, 1, 0, 107, 0, 0, 1.0, 51057, ss: 128 sss: 32 
0xb04862d030a38c351e8ecae09508cd30f80d88e3, 1820, 95, 89, 6, 0, 95, 0, 0, 1.0, 19236, ss: 128 sss: 32 
0x9c1e47b6e837bb34f33ea8a589330844ed884c64, 2422, 226, 215, 11, 0, 226, 0, 0, 1.0, 80383, ss: 128 sss: 32 
0xAEFc29485c7c5CeF5e51E2B4D672ad53e9F689e5, 2401, 215, 207, 8, 0, 215, 0, 0, 1.0, 64236, ss: 128 sss: 32 
0xaadf7d98128099889b90dd63d4b7a7604cc7d6d1, 2440, 219, 205, 14, 0, 219, 0, 0, 1.0, 36281, ss: 128 sss: 32 
0xfc6c01f6a43cafa741da7c6169b15f270791b6f0, 1518, 107, 106, 1, 0, 107, 0, 0, 1.0, 31891, ss: 128 sss: 32 
0xf5E10D109E56197256A5FD00ABA164d083bf8E38, 2676, 202, 199, 3, 0, 202, 0, 0, 1.0, 42972, ss: 128 sss: 32 
0xeb8919586c28017ad03ee29e59ff7b82e9db9672, 2263, 188, 179, 9, 0, 188, 0, 0, 1.0, 66196, ss: 128 sss: 32 
0x1370e65e0228b27566a5cb7328160794001f8651, 2426, 226, 215, 11, 0, 226, 0, 0, 1.0, 99110, ss: 128 sss: 32 
0x8857610Ba0A7caFD4dBE1120bfF03E9c74fc4124, 2534, 171, 162, 9, 0, 171, 0, 0, 1.0, 40775, ss: 128 sss: 32 
0x55a15dc18bb67b8687874d39cf69cbdac80ef645, 2808, 195, 187, 8, 0, 195, 0, 0, 1.0, 61427, ss: 128 sss: 32 
0xbbb00fa2a492430c871d9f5b4b44378c716ace19, 2304, 203, 193, 10, 0, 203, 0, 0, 1.0, 83559, ss: 128 sss: 32 
0x1e36a0182f1cb3ff3ee697293ed2e33cc261d809, 1942, 139, 137, 2, 0, 139, 0, 0, 1.0, 23033, ss: 128 sss: 32 
0x501f81d13780e228ab01ff0c9e9022747196d15f, 1665, 120, 119, 1, 0, 120, 0, 0, 1.0, 30915, ss: 128 sss: 32 
0x1d4AAEaE7C8b75a8e5ab589a84516853DBDdd735, 2054, 139, 136, 3, 0, 139, 0, 0, 1.0, 20746, ss: 128 sss: 32 
0x846960a07bace3c2dab828d91760a9ed2ba6e494, 1515, 107, 106, 1, 0, 107, 0, 0, 1.0, 52230, ss: 128 sss: 32 
0xcf02A395865a02533aC61dc0BA757D63791Ec5C4, 2928, 273, 256, 17, 0, 273, 0, 0, 1.0, 108132, ss: 128 sss: 32 
0x9703DfDce64f812317f519856d82C77015B56232, 2449, 219, 199, 20, 0, 219, 0, 0, 1.0, 66022, ss: 128 sss: 32 
0x4b53b097c1a7be54efcf859177da832f10dac517, 1371, 108, 107, 1, 0, 108, 0, 0, 1.0, 29073, ss: 128 sss: 32 
0x49199676b0f4e3891f3017e1bb79e554d6b39ba9, 1567, 105, 103, 2, 0, 105, 0, 0, 1.0, 18779, ss: 128 sss: 32 
0x0ac5b237ad37e5669d309e3451df585110318108, 1533, 109, 106, 3, 0, 109, 0, 0, 1.0, 57263, ss: 128 sss: 32 
0x67878f50086ffe346ad5918cf367473a02a0e5c7, 2346, 182, 181, 1, 0, 182, 0, 0, 1.0, 52028, ss: 128 sss: 32 
0x12721046Ad01eB97C2d58Cb518d512b4073F6813, 1331, 87, 87, 0, 0, 87, 0, 0, 1.0, 45874, ss: 128 sss: 32 
0xee13e63529c39f95926577f9acb2a6fdd912b141, 1467, 112, 111, 1, 0, 112, 0, 0, 1.0, 42485, ss: 128 sss: 32 
0xbaece6bdfb9fccbf0bdb9ba7e5f5c0ec1de5a250, 1363, 96, 95, 1, 0, 96, 0, 0, 1.0, 18252, ss: 128 sss: 32 
0x450712f1446851132ee3aa730220c61a94e0b519, 1513, 107, 106, 1, 0, 107, 0, 0, 1.0, 59745, ss: 128 sss: 32 
0xd5bcB7d3861050f19563bf8C7aD243c07Cf840FE, 1477, 104, 99, 5, 0, 104, 0, 0, 1.0, 3376, ss: 128 sss: 32 
0x46c8f149A43c96C089935621A3605d5e070A27D8, 2961, 275, 262, 13, 0, 275, 0, 0, 1.0, 80045, ss: 128 sss: 32 
0xd4dd7ef2445cc9d6d36de8d577e3bc8bab77acfc, 1519, 108, 106, 2, 0, 108, 0, 0, 1.0, 33351, ss: 128 sss: 32 
0xACA40632C51C2a03209D2714b88Aa0f1456A2101, 2709, 189, 181, 8, 0, 189, 0, 0, 1.0, 41528, ss: 128 sss: 32 
0x7603352f1C4752Ac07AAC94e48632b65FDF1D35c, 2282, 155, 148, 7, 0, 155, 0, 0, 1.0, 15165, ss: 128 sss: 32 
0x965c69aa539689ba326c8da4abe463406cc55171, 2928, 273, 256, 17, 0, 273, 0, 0, 1.0, 109664, ss: 128 sss: 32 
0x55bbe5a04d144d8d17dc6471f23e1a40b63333d4, 465, 19, 19, 0, 0, 19, 0, 0, 1.0, 282, ss: 128 sss: 32 
0xf5410917e13e42e540e7a8ff88c16de02021775d, 1512, 107, 106, 1, 0, 107, 0, 0, 1.0, 55592, ss: 128 sss: 32 
0x90911B716f5f193485BB74Af012C57514cAAabfd, 2931, 273, 256, 17, 0, 273, 0, 0, 1.0, 68742, ss: 128 sss: 32 
0x6479c975aee835dceac11570984b879ae6ccb7d2, 2306, 206, 194, 12, 0, 206, 0, 0, 1.0, 37236, ss: 128 sss: 32 
0xd6C1d391385F6a53bf02a7B4beD71441623D77e7, 2535, 115, 110, 5, 0, 115, 0, 0, 1.0, 75697, ss: 128 sss: 32 
0x1C1100a0769e3F0137A6c05c71a0Ece53f08A299, 2952, 275, 262, 13, 0, 275, 0, 0, 1.0, 66906, ss: 128 sss: 32 
0x000e6c9642fc7ae19caf9760ad2a538d5cc8cca6, 1883, 145, 144, 1, 0, 145, 0, 0, 1.0, 32341, ss: 128 sss: 32 
0x0d17918b0ba11b9b8d5455f434a8221bfc3672bc, 1511, 110, 109, 1, 0, 110, 0, 0, 1.0, 20367, ss: 128 sss: 32 
0xd51e266ffcaced6a8073021df3460f5d4efb81a9, 1932, 161, 154, 7, 0, 161, 0, 0, 1.0, 44272, ss: 128 sss: 32 
0x51221550f9ce9435ef252f7f863403600804ae9c, 1962, 147, 141, 6, 0, 147, 0, 0, 1.0, 27915, ss: 128 sss: 32 
0xced519a9e7555dee0399f8da3019d8d557a88f81, 1564, 103, 103, 0, 0, 103, 0, 0, 1.0, 41927, ss: 128 sss: 32 
0x9ac08d676f5fcab22418101c722e07e60974f627, 1776, 140, 137, 3, 0, 140, 0, 0, 1.0, 43318, ss: 128 sss: 32 
0x5e8b97e1015033c6422a2e51645d0c9fbcb97553, 1521, 107, 106, 1, 0, 107, 0, 0, 1.0, 57617, ss: 128 sss: 32 
0xbbf4a7020fe5ec9d8fa9e5bc1fdc81886fd2b837, 1372, 99, 98, 1, 0, 99, 0, 0, 1.0, 18074, ss: 128 sss: 32 
0xd735b55b674209f478763cde946a7beeaabbded4, 1521, 107, 106, 1, 0, 107, 0, 0, 1.0, 61328, ss: 128 sss: 32 
0x25E54Bf48369b8FB25bB79d3a3Ff7F3BA448E382, 2361, 125, 118, 7, 0, 125, 0, 0, 1.0, 976, ss: 128 sss: 32 
0x81ef2af332cf422cf51aea1e1a284c01e7f10336, 1505, 110, 110, 0, 0, 110, 0, 0, 1.0, 44585, ss: 128 sss: 32 
0xc63d93b65754ae7356da3bad12abd02101306252, 1904, 171, 159, 12, 0, 171, 0, 0, 1.0, 34424, ss: 128 sss: 32 
0x3772c33fede7d7cd5fb587a96707736a38651d2a, 2939, 273, 256, 17, 0, 273, 0, 0, 1.0, 76819, ss: 128 sss: 32 
0x3ea06c27b0e18f4cb977eea6ad0b0b3a1d3e8577, 1390, 110, 110, 0, 0, 110, 0, 0, 1.0, 29198, ss: 128 sss: 32 
0x6ea4f5bcd17185c5958677569340e39ac6364e9f, 1512, 107, 106, 1, 0, 107, 0, 0, 1.0, 71781, ss: 128 sss: 32 
0x726c8bf7c2bc8d6f76e484dbfc4dceddf3c35fae, 1586, 108, 108, 0, 0, 108, 0, 0, 1.0, 53067, ss: 128 sss: 32 
0x4b74cf20b99b89f5bcdd7d099e13df709eec7547, 1622, 114, 113, 1, 0, 114, 0, 0, 1.0, 26603, ss: 128 sss: 32 
0x5eC34376205E99f5314cD71436AFDA100f3A4Bb6, 1072, 43, 43, 0, 0, 43, 0, 0, 1.0, 1763, ss: 128 sss: 32 
0x910ac8d84d2badcceeb859dbb624b69d430758cd, 1606, 108, 108, 0, 0, 108, 0, 0, 1.0, 51493, ss: 128 sss: 32 
0xee9b308d27bc836d69ebab50fc930582acc9ee51, 1513, 107, 106, 1, 0, 107, 0, 0, 1.0, 33149, ss: 128 sss: 32 
0x641d512a5a3be7f07ede4bb66fcc3546b5c24622, 1005, 84, 81, 3, 0, 84, 0, 0, 1.0, 25899, ss: 128 sss: 32 
0xb514f1da82e60b542462b7dcbd5bcf7d8d833c71, 1513, 107, 106, 1, 0, 107, 0, 0, 1.0, 57215, ss: 128 sss: 32 
0x5d207dbd80b978b138331519383b27caa1e04999, 253, 18, 18, 0, 0, 18, 0, 0, 1.0, 62, ss: 128 sss: 32 
0xc1cf2a2a36b3ff8f9d334d290fd5276fd11cb470, 2895, 228, 220, 8, 0, 228, 0, 0, 1.0, 58401, ss: 128 sss: 32 
0xe015fc859b3f6a42a383930862c390fb4bdffdab, 1581, 108, 108, 0, 0, 108, 0, 0, 1.0, 57588, ss: 128 sss: 32 
0x6900bcec43657360fb5a08ae4d4bc4523db1ef57, 2859, 247, 233, 14, 0, 247, 0, 0, 1.0, 102884, ss: 128 sss: 32 
0x1991a5BfCC94269E7ADc1363B606535d52e34B50, 2155, 164, 149, 15, 0, 164, 0, 1, 1.0, 15939, ss: 128 sss: 32 
0x37d037f8fc5d822eb8921739438048e19b7e7151, 2114, 155, 154, 1, 0, 155, 0, 0, 1.0, 40380, ss: 128 sss: 32 
0x28e762c8f9e897e15534665046b10304eeef2619, 2439, 179, 178, 1, 0, 179, 0, 0, 1.0, 40261, ss: 128 sss: 32 
0x0c56dfe9ac6be6a1708830b69485e1ab1c471416, 1447, 101, 100, 1, 0, 101, 0, 0, 1.0, 49211, ss: 128 sss: 32 
0xF7cBC808982732ac1eB3D3da6A870Ea5A4f673bE, 2979, 275, 262, 13, 0, 275, 0, 0, 1.0, 71206, ss: 128 sss: 32 
0x4a053b7c4cbbe72300f1986e39881bd21d646536, 2527, 188, 183, 5, 0, 188, 0, 0, 1.0, 9068, ss: 128 sss: 32 
0x315eeec667344f44ad212aaf4f7e3e663613b8a5, 1518, 107, 106, 1, 0, 107, 0, 0, 1.0, 60167, ss: 128 sss: 32 
0xa72d663133699d8c1e2987bdb7265e8deb7756ac, 1217, 87, 87, 0, 0, 87, 0, 0, 1.0, 10021, ss: 128 sss: 32 
0x8c933c7bb7812946e59bdaf81a437c56b4661fd0, 1581, 107, 106, 1, 0, 107, 0, 0, 1.0, 43917, ss: 128 sss: 32 
0x682bcb2d23693362018a9f272964217dcedd7841, 1539, 101, 100, 1, 0, 101, 0, 0, 1.0, 42334, ss: 128 sss: 32 
0x5a67e970cc210d6b5fb6512d8142e3eb648c1d32, 2845, 247, 233, 14, 0, 247, 0, 0, 1.0, 112103, ss: 128 sss: 32 
0x8582d90c24b6379ea59236889c014c6576c8bf19, 1508, 107, 106, 1, 0, 107, 0, 0, 1.0, 49112, ss: 128 sss: 32 
0x09fe27a16512c8252df5ec35537827f53aeb037c, 1508, 107, 106, 1, 0, 107, 0, 0, 1.0, 60162, ss: 128 sss: 32 
0x110429d46bb2e1e731f390e74e045f86e524ff24, 1706, 135, 135, 0, 0, 135, 0, 0, 1.0, 40537, ss: 128 sss: 32 
0xfddee5567aa7f686251726f66781eb0c25f031bc, 1191, 85, 84, 1, 0, 85, 0, 0, 1.0, 12702, ss: 128 sss: 32 
0xb1a9eccf24d863b5773b867bf5535fe1926fbc17, 1879, 145, 144, 1, 0, 145, 0, 0, 1.0, 35422, ss: 128 sss: 32 
0xa7c7f7ec642ac45605c38024a00c578c0c513ea5, 2888, 278, 270, 8, 0, 278, 0, 0, 1.0, 114873, ss: 128 sss: 32 
0x2fa57c80249b0683c443043aB01b894125876AfC, 1465, 117, 116, 1, 0, 117, 0, 0, 1.0, 38187, ss: 128 sss: 32 
0x3B1554f346DFe5c482Bb4BA31b880c1C18412170, 177, 16, 16, 0, 0, 16, 0, 0, 1.0, 45, ss: 128 sss: 32 
0x769f6f368cc9949d29065da366fb86dbe9024367, 1594, 107, 106, 1, 0, 107, 0, 0, 1.0, 25210, ss: 128 sss: 32 
0xaa4431550f4edf11e294a1b778bee7842eeb445a, 2597, 274, 221, 53, 0, 274, 0, 0, 1.0, 48814, ss: 128 sss: 32 
0xf7a9affda0aba42d9e625d8a119bf4f15d1921f7, 453, 38, 38, 0, 0, 38, 0, 0, 1.0, 77, ss: 128 sss: 32 
0x629ea6c3957e3cbf460e4697822516263d796be5, 1938, 141, 140, 1, 0, 141, 0, 0, 1.0, 24589, ss: 128 sss: 32 
0x228ce526d70cd1d7853edfc39aa84e5e3438f4fc, 1478, 121, 121, 0, 0, 121, 0, 0, 1.0, 27118, ss: 128 sss: 32 
0xc00c150508dc90437433a9079aaa29de2da31d71, 2732, 285, 256, 29, 0, 285, 0, 0, 1.0, 77620, ss: 128 sss: 32 
0xdd0ea4ce78b4d2065ad220af61ff5233a56e2617, 2383, 168, 163, 5, 0, 168, 0, 0, 1.0, 103188, ss: 128 sss: 32 
0x2704805cad015a69eeac6c76e6f36edeabf0d1e7, 2845, 205, 195, 10, 0, 205, 0, 1, 1.0, 54362, ss: 128 sss: 32 
0x726Fbe4904E47D6d24AC01FeF435dF98d36440A0, 1334, 88, 87, 1, 0, 88, 0, 0, 1.0, 30559, ss: 128 sss: 32 
0xe216bca30d4165b5434db5f3013d8a2f67ac220a, 2032, 162, 149, 13, 0, 162, 0, 0, 1.0, 24406, ss: 128 sss: 32 
0x7a0b09c1974360d0370063ee7761d29803d45a74, 1009, 84, 81, 3, 0, 84, 0, 0, 1.0, 37150, ss: 128 sss: 32 
0xfb30c43c68655f002633e568dc3e9c81f457be29, 1511, 107, 106, 1, 0, 107, 0, 0, 1.0, 33649, ss: 128 sss: 32 
0xAc7CDCf645cCB9672263F010E9ef686920c5Eca0, 2854, 247, 234, 13, 0, 247, 0, 0, 1.0, 107361, ss: 128 sss: 32 
0x97a6d180BFd8Bbd20907FEB24025A4e859dc4403, 2946, 273, 256, 17, 0, 273, 0, 0, 1.0, 140258, ss: 128 sss: 32 
0xfdfbfd2369a0de35a2b83827afd5288e73c82812, 1525, 115, 113, 2, 0, 115, 0, 0, 1.0, 23834, ss: 128 sss: 32 
0xbc631fbebd6d48ead35e7c9c5bc5be534b6dd504, 1521, 107, 106, 1, 0, 107, 0, 0, 1.0, 38616, ss: 128 sss: 32 
0x987847215a0beb8cf736a80b7bc2da80cc73eb17, 1509, 107, 106, 1, 0, 107, 0, 0, 1.0, 35077, ss: 128 sss: 32 
0xc6f9b3e1037d747166172b76d02fa38aadba94b9, 1510, 127, 127, 0, 0, 127, 0, 0, 1.0, 37914, ss: 128 sss: 32 
0xf859256858091a7d78f0ae8dfe91cb30e5b1bc65, 600, 40, 37, 3, 0, 40, 0, 0, 1.0, 8887, ss: 128 sss: 32 
0xfed173af9ff5ae26130ea840d85c73d015f917e7, 2462, 221, 211, 10, 0, 221, 0, 0, 1.0, 38763, ss: 128 sss: 32 
0x0485a1d415f93910e1f2cedc2773730e95d200bc, 2893, 278, 270, 8, 0, 278, 0, 0, 1.0, 72690, ss: 128 sss: 32 
0x42c5c42739078a21383c98431e8f8e553ecbdfe2, 1039, 68, 68, 0, 0, 68, 0, 0, 1.0, 10474, ss: 128 sss: 32 
0xda68f0f91a4e444454c42e5e1ee66580299c4fc6, 1518, 107, 106, 1, 0, 107, 0, 0, 1.0, 49147, ss: 128 sss: 32 
0xaef558941a04e006b46c7f0c877547ccc1fda3a4, 1143, 69, 69, 0, 0, 69, 0, 0, 1.0, 798, ss: 128 sss: 32 
0xfa74c2c7568ab156ade70e9d9c8610e71df3794d, 1358, 120, 120, 0, 0, 120, 0, 0, 1.0, 163442, ss: 128 sss: 32 
0x6fb85e888e9e3b94cfe91ee864c80d1b6ef6c470, 1621, 114, 113, 1, 0, 114, 0, 0, 1.0, 50517, ss: 128 sss: 32 
0xcb5c447567631b187eea240512ba2fbbc875ce1d, 520, 34, 27, 7, 0, 34, 0, 0, 1.0, 98, ss: 128 sss: 32 
0x027e7c254a14a51d672db86a781646f46912027c, 1023, 84, 81, 3, 0, 84, 0, 0, 1.0, 20439, ss: 128 sss: 32 
0x3eaa5b461eb2832c98c6eb5682de7eacc5f8a2aa, 2527, 176, 172, 4, 0, 176, 0, 0, 1.0, 53848, ss: 128 sss: 32 
0x47b91dec4cf20836ee90e56c51ffbd9c4342987a, 2860, 247, 234, 13, 0, 247, 0, 0, 1.0, 91159, ss: 128 sss: 32 
0x3b9e222f2a8fb9fc36083516aa41ba6010c9690e, 1582, 108, 108, 0, 0, 108, 0, 0, 1.0, 56182, ss: 128 sss: 32 
0x9A33ae87352eB9a171f34113C6333AA18D8ef6d2, 2393, 225, 212, 13, 0, 225, 0, 0, 1.0, 57761, ss: 128 sss: 32 
0xa944c2e3b8356a26cd788ed4e2655720261e02cb, 153, 9, 9, 0, 0, 9, 0, 0, 1.0, 1241, ss: 128 sss: 32 
0xA0C4E8a82849EEca6A2Bcec00c9Cf72EBB28ebBE, 2034, 163, 156, 7, 0, 163, 0, 0, 1.0, 43184, ss: 128 sss: 32 
0xfd9206d44f14dc2091f3a2e75dfa06bc8b8609cc, 1518, 108, 106, 2, 0, 108, 0, 0, 1.0, 53859, ss: 128 sss: 32 
0x5f3f38818f37aa890b9a245a9458d8ebf9aa93de, 1504, 107, 106, 1, 0, 107, 0, 0, 1.0, 57229, ss: 128 sss: 32 
0xb032e5364e141c71d33c32388555662ad63d66b5, 1530, 107, 106, 1, 0, 107, 0, 0, 1.0, 50417, ss: 128 sss: 32 
0x1041D127b2d4BC700F0F563883bC689502606918, 1911, 149, 146, 3, 0, 149, 0, 0, 1.0, 27704, ss: 128 sss: 32 
0x0c6b8078d27c9729fad5db98c331291bf57ec879, 1516, 107, 106, 1, 0, 107, 0, 0, 1.0, 74265, ss: 128 sss: 32 
0xcbce33a40e6b52e28c53abf7d12d4cba961312f7, 1384, 110, 110, 0, 0, 110, 0, 0, 1.0, 17988, ss: 128 sss: 32 
0x6f69f8fb606a6b6f588a67ab96dffcd1a0d17921, 1512, 107, 106, 1, 0, 107, 0, 0, 1.0, 54972, ss: 128 sss: 32 
0x01862Ecae91956396dF56479694A4D79920C0246, 148, 9, 9, 0, 0, 9, 0, 0, 1.0, 61, ss: 128 sss: 32 
0xe9262aa028e6dfeb1dca3bb1c07faf0707544b86, 719, 54, 54, 0, 0, 54, 0, 0, 1.0, 204, ss: 128 sss: 32 
0x9960012D71d2085516646B411925AD1d115ED01F, 170, 8, 6, 2, 0, 8, 0, 0, 1.0, 20, ss: 128 sss: 32 
0x7Afa3d0E44046C7ce8094dC429305A7ff3706D10, 184, 8, 6, 2, 0, 8, 0, 0, 1.0, 32, ss: 128 sss: 32 
0x701334aad9b95cc05836a36f9a4382ddfe2f2135, 1517, 107, 106, 1, 0, 107, 0, 0, 1.0, 60552, ss: 128 sss: 32 
0x9bed7f4ce96d0dcd1913ad251b3195d3dbf54de8, 1615, 115, 114, 1, 0, 115, 0, 0, 1.0, 31641, ss: 128 sss: 32 
0x5b73c0c7c3c93e1b0d69296ef156ddd63e368a2b, 1113, 79, 78, 1, 0, 79, 0, 0, 1.0, 16275, ss: 128 sss: 32 
0xe1a6d95925ea986a4f15a14bfd9e2c0a6ebcc1cc, 1523, 107, 106, 1, 0, 107, 0, 0, 1.0, 35425, ss: 128 sss: 32 
0xf1a716eb3388863e9f8674bb10d05e47a5691176, 2479, 170, 165, 5, 0, 170, 0, 0, 1.0, 83447, ss: 128 sss: 32 
0x33f9704b980a21b776eac1d9d4111db33ab6dfda, 1428, 101, 100, 1, 0, 101, 0, 0, 1.0, 59995, ss: 128 sss: 32 
0x6D17e88Ade441073cc3ebFc2533CEf105Dab12aF, 2832, 262, 242, 20, 0, 262, 0, 0, 1.0, 44820, ss: 128 sss: 32 
0x0f924f391a923a375a302be558e05b0972d39c04, 1519, 107, 106, 1, 0, 107, 0, 0, 1.0, 58864, ss: 128 sss: 32 
0xa86Da83DC8E217f241aA1FdB658De12f48729E19, 1976, 175, 160, 15, 0, 175, 0, 0, 1.0, 37529, ss: 128 sss: 32 
0x8133abdEA78663357f1b8FAA5fDf9b267AF13a5E, 2777, 245, 232, 13, 0, 245, 0, 0, 1.0, 49765, ss: 128 sss: 32 
0xDADe671951f27fA448336127908fcC4473a1db25, 2861, 248, 223, 25, 0, 248, 0, 0, 1.0, 39078, ss: 128 sss: 32 
0x331bd2fa86ba9f5f0144bf0131abb3773184f508, 2889, 278, 270, 8, 0, 278, 0, 0, 1.0, 130383, ss: 128 sss: 32 
0x357d13A7B8d6127BF29C3aCA74b61CAb26Dbcd31, 2833, 245, 228, 17, 0, 245, 0, 0, 1.0, 72584, ss: 128 sss: 32 
0xb750b9969cf462961a157127b090f091a22d3b66, 2150, 195, 183, 12, 0, 195, 0, 0, 1.0, 45732, ss: 128 sss: 32 
0x042074AAdD6d49e74d2e0164FfeFccD1FD66Cc39, 1316, 87, 87, 0, 0, 87, 0, 0, 1.0, 44781, ss: 128 sss: 32 
0x0d7f8b1276fdd71adfb507c2800a69607f202947, 2422, 219, 205, 14, 0, 219, 0, 0, 1.0, 62601, ss: 128 sss: 32 
0xc986d9b475def824c15fa9f0b1164add28bf42f8, 1369, 108, 107, 1, 0, 108, 0, 0, 1.0, 26161, ss: 128 sss: 32 
0xdd157bd06c1840fa886da18a138c983a7d74c1d7, 2248, 177, 171, 6, 0, 177, 0, 0, 1.0, 73210, ss: 128 sss: 32 
0x10d5f3898fc9505070dd8c22463d03ae073207d5, 2254, 151, 147, 4, 0, 151, 0, 0, 1.0, 51640, ss: 128 sss: 32 
0x2f6b12ab24186f5e4e33698b4c9d137a6e1d6f40, 2885, 278, 270, 8, 0, 278, 0, 0, 1.0, 142685, ss: 128 sss: 32 
0xa0c33f9502cb5c4dac3dff2d2119810053bfd776, 2421, 226, 215, 11, 0, 226, 0, 0, 1.0, 54357, ss: 128 sss: 32 
0xa0111e7714FF8fF347304E9C87CC0234c88CA35A, 2849, 247, 234, 13, 0, 247, 0, 0, 1.0, 99605, ss: 128 sss: 32 
0x398205434693c517f9992dec67c6809f617d8d9f, 2827, 262, 242, 20, 0, 262, 0, 0, 1.0, 33099, ss: 128 sss: 32 
0x6f202fe2b7b8571c675f3c0e531a4c446b2a28f8, 1557, 111, 109, 2, 0, 111, 0, 0, 1.0, 12591, ss: 128 sss: 32 
0xebe3C2fe67B81B1a7a6B0182c42D2cE88613E8ad, 2320, 203, 193, 10, 0, 203, 0, 0, 1.0, 66444, ss: 128 sss: 32 
0x75c7bd27a5add7cd6a248e6a43419f3757ac4a86, 2267, 151, 147, 4, 0, 151, 0, 0, 1.0, 91749, ss: 128 sss: 32 
0x1b51AE89822E66Ad6f8CfC4a40cC4aea6641A181, 2525, 115, 110, 5, 0, 115, 0, 0, 1.0, 61856, ss: 128 sss: 32 
0x0b0bb5209926b42d0e553d1ac2e3be0d005e4acc, 2651, 198, 195, 3, 0, 198, 0, 0, 1.0, 39039, ss: 128 sss: 32 
0xc3B006Cf383f33342910a8cd5706D4d76851a55C, 169, 8, 6, 2, 0, 8, 0, 0, 1.0, 11, ss: 128 sss: 32 
0x7acda3f4826da110fe8b7d8558bb89f7ba4198e7, 2713, 242, 227, 15, 0, 242, 0, 0, 1.0, 52884, ss: 128 sss: 32 
0x69263f3f4ba01f9e317ccebc9ef3cb2bcf8bab9b, 2734, 212, 201, 11, 0, 212, 0, 0, 1.0, 30699, ss: 128 sss: 32 
0x53e020Aa5Cd22E1369373e0F61Df6DCF4E5aB127, 2954, 275, 262, 13, 0, 275, 0, 0, 1.0, 123139, ss: 128 sss: 32 
0xeD3de6B0C6BCf88044E3B548c7de6F0ef99DaD07, 1325, 87, 87, 0, 0, 87, 0, 0, 1.0, 46541, ss: 128 sss: 32 
0xc7384444c5be31ee780085a669f408e5d51d6c2f, 1620, 110, 109, 1, 0, 110, 0, 0, 1.0, 38455, ss: 128 sss: 32 
0x20706e9e43127f002dac9388ca58ee2ee7dc1060, 1526, 107, 106, 1, 0, 107, 0, 0, 1.0, 50785, ss: 128 sss: 32 
0x72ff149F3CCE8DB0F54644cBe15849e8b7f095fC, 2933, 273, 256, 17, 0, 273, 0, 0, 1.0, 140055, ss: 128 sss: 32 
0x61c780024ab952f114c097586c73c878dd297cc8, 1516, 107, 106, 1, 0, 107, 0, 0, 1.0, 58065, ss: 128 sss: 32 
0xb6fd64b6eb04491de699f258f206c1f4a6024562, 1521, 107, 106, 1, 0, 107, 0, 0, 1.0, 35462, ss: 128 sss: 32 
0x72af7375d1848eadc10d600c0f5d611619ae7f7f, 1505, 107, 106, 1, 0, 107, 0, 0, 1.0, 34000, ss: 128 sss: 32 
0x7bc0a3cc5a75256c12df4c3a9fbb8ecbbcd57f9c, 2030, 151, 150, 1, 0, 151, 0, 0, 1.0, 57537, ss: 128 sss: 32 
0x1419d80b34c355ea5ade0a04b17ec0b903067d37, 1509, 107, 106, 1, 0, 107, 0, 0, 1.0, 62494, ss: 128 sss: 32 
0xd3a8cdf3f6bc817e97b61a5fa00e7c74f2edc138, 1528, 107, 106, 1, 0, 107, 0, 0, 1.0, 31634, ss: 128 sss: 32 
0x2c6a3729b26c09fe41b45500584bf2885aff436a, 2962, 275, 262, 13, 0, 275, 0, 0, 1.0, 55668, ss: 128 sss: 32 
0x52cb2f74865d2d1d1444ea58512ba3a9fef9bcb9, 1385, 96, 95, 1, 0, 96, 0, 0, 1.0, 31843, ss: 128 sss: 32 
0xbb143d6939b9c0ca396e1de0df51ea4e4a911678, 1517, 107, 106, 1, 0, 107, 0, 0, 1.0, 30642, ss: 128 sss: 32 
0x0aca8732dfa675efa103617cf5f95f3703674612, 2352, 173, 173, 0, 0, 173, 0, 0, 1.0, 58257, ss: 128 sss: 32 
0xc32aca022fde174e15c70c7d1a5fc2e7e291d100, 1399, 110, 110, 0, 0, 110, 0, 0, 1.0, 16164, ss: 128 sss: 32 
0xc4772Be15F0483672CD5f16CA06456c46908B61c, 2106, 107, 106, 1, 0, 107, 0, 0, 1.0, 42840, ss: 128 sss: 32 
0x8d9c69ef0c5976cc4771f5cab66559cb8b04a240, 1517, 107, 106, 1, 0, 107, 0, 0, 1.0, 73625, ss: 128 sss: 32 
0xcc5638ed6a722738321d68af499b9297ff50fca0, 2301, 220, 209, 11, 0, 220, 0, 0, 1.0, 39669, ss: 128 sss: 32 
0xe708b56ba047d01e8cc643100650a9b0da4f89b4, 1343, 86, 82, 4, 0, 86, 0, 0, 1.0, 8977, ss: 128 sss: 32 
0x061d6F7893abF18e7ff0ca44B44d8d13bDF57225, 2970, 275, 262, 13, 0, 275, 0, 0, 1.0, 114240, ss: 128 sss: 32 
0xe9575047C490bad50A910a61cEfdd5E0b2Bd5217, 2170, 197, 189, 8, 0, 197, 0, 0, 1.0, 47758, ss: 128 sss: 32 
0x8ec09534d908562e56026218b7a006ca41f006e6, 1514, 107, 106, 1, 0, 107, 0, 0, 1.0, 51882, ss: 128 sss: 32 
0x9761b7c301b57ead03f51186158482d8adf73eba, 1228, 87, 87, 0, 0, 87, 0, 0, 1.0, 16112, ss: 128 sss: 32 
0xAb113Ad58dfD4b495881b4d2F4768D2ac37E1bd2, 2935, 273, 256, 17, 0, 273, 0, 0, 1.0, 75548, ss: 128 sss: 32 
0x5903c054fdf73c98791a7d215d4f2e29a0908b68, 563, 23, 23, 0, 0, 23, 0, 0, 1.0, 315, ss: 128 sss: 32 
0xba2fbcd69d5f1dcb71dd9f6e9017e8a85bc2f730, 2745, 218, 216, 2, 0, 218, 0, 0, 1.0, 27443, ss: 128 sss: 32 
0xa3f8e6e633a9b5b92677b13a29d2290354690686, 1510, 107, 106, 1, 0, 107, 0, 0, 1.0, 35956, ss: 128 sss: 32 
0xbc38892981a3a6e0196c71f5184dcf95d57d9cb0, 1525, 108, 106, 2, 0, 108, 0, 0, 1.0, 53627, ss: 128 sss: 32 
0x142404cfcab80f0e62c260f31ac3b79d179981f4, 1366, 96, 95, 1, 0, 96, 0, 0, 1.0, 39513, ss: 128 sss: 32 
0x328f8c6ec544b92e194c705eba2a9dbbbeb17e9a, 1879, 156, 148, 8, 0, 156, 0, 0, 1.0, 51953, ss: 128 sss: 32 
0x9c5383bf0b6ac3f7016a0946f9163f56a32d7285, 1573, 108, 107, 1, 0, 108, 0, 0, 1.0, 46395, ss: 128 sss: 32 
0x80a88dc663fa256e34ecb5a47314702313b162a5, 2241, 177, 171, 6, 0, 177, 0, 0, 1.0, 41207, ss: 128 sss: 32 
0x5d33438f55ef68ac12584d22cff27c5acab6846d, 1391, 110, 110, 0, 0, 110, 0, 0, 1.0, 18512, ss: 128 sss: 32 
0x946c04c21e5aac944be581e4bcbc98aefb23bed2, 1744, 138, 134, 4, 0, 138, 0, 0, 1.0, 36596, ss: 128 sss: 32 
0x6Dd69717B1194B81A92105B7e0F94cb40f68A3e3, 1704, 136, 131, 5, 0, 136, 0, 1, 1.0, 51768, ss: 128 sss: 32 
0xfcd102ddd7f50d5195b8a616596f422f6332c8c3, 1525, 107, 106, 1, 0, 107, 0, 0, 1.0, 48860, ss: 128 sss: 32 
0xca9730647af97591ffe184f96a2b39bc4c7148c6, 2878, 277, 264, 13, 0, 277, 0, 0, 1.0, 157947, ss: 128 sss: 32 
0x31d8797afccc59421b66ceab28e2a5cf9e4a612a, 1512, 107, 106, 1, 0, 107, 0, 0, 1.0, 59414, ss: 128 sss: 32 
0x2cfC31b4e1E838453c22675F46bB248AC9DDD439, 2969, 275, 262, 13, 0, 275, 0, 0, 1.0, 123035, ss: 128 sss: 32 
0xb5613bee25f155279ab3eb8c6a4258dd9b08f1e9, 1523, 107, 106, 1, 0, 107, 0, 0, 1.0, 36813, ss: 128 sss: 32 
0x5f24E4a1A1f134a5a6952A9965721E6344898497, 2513, 175, 172, 3, 0, 175, 0, 0, 1.0, 39011, ss: 128 sss: 32 
0x5b1fe98af639fc04f74b381d470e6a952f5628b0, 1908, 148, 147, 1, 0, 148, 0, 0, 1.0, 38136, ss: 128 sss: 32 
0x0a7f6ded28ff24225af74864db58d7bb8f524bff, 1647, 115, 112, 3, 0, 115, 0, 0, 1.0, 17632, ss: 128 sss: 32 
0x72257e987bbaefbd71354eb9bf8f15c07b07facb, 1518, 107, 106, 1, 0, 107, 0, 0, 1.0, 61641, ss: 128 sss: 32 
0xcdf77a4fda05a15d87c1a851367cd727fa1f3893, 1540, 101, 100, 1, 0, 101, 0, 0, 1.0, 39393, ss: 128 sss: 32 
0xef4848E45b8B07c2fe5f897fDfF03C6050CF7c6c, 2003, 170, 163, 7, 0, 170, 0, 0, 1.0, 78844, ss: 128 sss: 32 
0xabb005F55db5818983A4CF097ae68C3E797a83dF, 2305, 203, 193, 10, 0, 203, 0, 0, 1.0, 81981, ss: 128 sss: 32 
0xcbe2cb2511e4fc2ca3552a65cf95324a5786c64f, 1492, 103, 103, 0, 0, 103, 0, 0, 1.0, 81218, ss: 128 sss: 32 
0x772358ef6ed3e18BdE1263F7d229601c5fa81875, 2098, 196, 183, 13, 0, 196, 0, 0, 1.0, 78347, ss: 128 sss: 32 
0x805fc89dd56b88d5a93e2156113f782015343b0a, 2167, 199, 189, 10, 0, 199, 0, 0, 1.0, 74597, ss: 128 sss: 32 
0x563c83AAb5690A891cca502a2c0D0ed186fc277a, 2757, 255, 238, 17, 0, 255, 0, 0, 1.0, 92861, ss: 128 sss: 32 
0xeaa7a52503467fb6837ea15bb4cd525f5221c145, 2266, 151, 147, 4, 0, 151, 0, 0, 1.0, 50811, ss: 128 sss: 32 
0xda46C0Dc2195d326284186b89AAb71ACFF56cC8e, 1966, 140, 139, 1, 0, 140, 0, 0, 1.0, 32359, ss: 128 sss: 32 
0xe83a37ce9225f55984da6b2d47df6d65734cede8, 1536, 115, 114, 1, 0, 115, 0, 0, 1.0, 33473, ss: 128 sss: 32 
0xf5ca50556e5a15dbd32febbddee66d6378d42565, 745, 57, 57, 0, 0, 57, 0, 0, 1.0, 1395, ss: 128 sss: 32 
0xE3deFaE93FabDC93da32aEc7FF71d5EC85e2e0bb, 2439, 177, 176, 1, 0, 177, 0, 0, 1.0, 51077, ss: 128 sss: 32 
0x3c00fcf488712cd0430b6d4c77d6e48c3718a0ef, 1523, 127, 127, 0, 0, 127, 0, 0, 1.0, 23888, ss: 128 sss: 32 
0xde50f45369c6df145e136ed9908b9ff8e5d85864, 1643, 115, 114, 1, 0, 115, 0, 0, 1.0, 45547, ss: 128 sss: 32 
0x69ca381d779b5f2419ecfb5e35c1c619f3c7ed19, 1948, 173, 165, 8, 0, 173, 0, 0, 1.0, 36778, ss: 128 sss: 32 
0x37c1f2469d510449a847e4e5c48607a2fc9aa223, 1206, 85, 84, 1, 0, 85, 0, 0, 1.0, 18798, ss: 128 sss: 32 
0x72ad683f8608ddae0e1c80db6bba0913dc813bb3, 1483, 103, 103, 0, 0, 103, 0, 0, 1.0, 33301, ss: 128 sss: 32 
0xf67ebd7c7580f043f6d49183ba49640adaf67edc, 1522, 107, 106, 1, 0, 107, 0, 0, 1.0, 38240, ss: 128 sss: 32 
0x923450622cf5350bb37391859c15e9b9b61866e4, 1516, 107, 106, 1, 0, 107, 0, 0, 1.0, 51794, ss: 128 sss: 32 
0x7e8f0ef6fec4a2cc78151b1103fcbb47c01807f2, 2026, 151, 150, 1, 0, 151, 0, 0, 1.0, 59449, ss: 128 sss: 32 
0x5a96707ae44f13c19b5868656b319f82cb501dec, 1365, 96, 95, 1, 0, 96, 0, 0, 1.0, 31783, ss: 128 sss: 32 
0xA416A7a07925d60F794E20532bc730749611A220, 2389, 189, 185, 4, 0, 189, 0, 0, 1.0, 20434, ss: 128 sss: 32 
0xe9398a05bb971ad753f7910e5a7d0d7b79b487b4, 1554, 114, 113, 1, 0, 114, 0, 0, 1.0, 20414, ss: 128 sss: 32 
0xF7DB9aFf4ED515e1cFe9560265ec040300B05B2A, 1682, 159, 150, 9, 0, 159, 0, 0, 1.0, 18339, ss: 128 sss: 32 
0x27d5d28fb73fc1eb2961806fcf3c3833c6ba7568, 1512, 107, 106, 1, 0, 107, 0, 0, 1.0, 72460, ss: 128 sss: 32 
0x651d459e96f75318acd83ead8543eee2ef6e8abe, 1519, 107, 106, 1, 0, 107, 0, 0, 1.0, 53498, ss: 128 sss: 32 
0xdeaed9594451001b32fccf2d6793f5491ec4d80b, 1607, 110, 109, 1, 0, 110, 0, 0, 1.0, 19925, ss: 128 sss: 32 
0x435197f681B01511C1bF6422c1Ba5272216e2B8A, 2972, 216, 206, 10, 0, 216, 0, 0, 1.0, 77764, ss: 128 sss: 32 
0xe4bd3602469ce50017cc85a553dcd9765f3597aa, 1487, 108, 107, 1, 0, 108, 0, 0, 1.0, 49219, ss: 128 sss: 32 
0xf08c9700eb390b94f5ff0c458af4d4e5c17e5ada, 1511, 107, 106, 1, 0, 107, 0, 0, 1.0, 55088, ss: 128 sss: 32 
0xF0B4ea93D9a0BC037B84f13Fccb28e4d844037d2, 2857, 248, 223, 25, 0, 248, 0, 0, 1.0, 64917, ss: 128 sss: 32 
0xa12a3b10020f63caee848bb347600906a15c712e, 1530, 108, 106, 2, 0, 108, 0, 0, 1.0, 36488, ss: 128 sss: 32 
0xc8bf8bc34874e07f6a0d4abc8be22ba9e372631b, 2787, 259, 237, 22, 0, 259, 0, 0, 1.0, 53473, ss: 128 sss: 32 
0xa30262735e655220454a5da24997bf40a05a2fff, 2289, 206, 198, 8, 0, 206, 0, 0, 1.0, 58149, ss: 128 sss: 32 
0x734ac0512cc24b22503521a87127bea43b2a1e62, 1508, 107, 106, 1, 0, 107, 0, 0, 1.0, 34416, ss: 128 sss: 32 
0xce85d05d57c4b16a09de0133c2abedf1bfeea57c, 1366, 96, 95, 1, 0, 96, 0, 0, 1.0, 40175, ss: 128 sss: 32 
0xadcd3c6c45a1d0de0f32a98cb81acceebcda0f08, 1526, 107, 106, 1, 0, 107, 0, 0, 1.0, 71861, ss: 128 sss: 32 
0x0e0127cefb7d382cea8d2be428056666c59d98a7, 1870, 145, 144, 1, 0, 145, 0, 0, 1.0, 22011, ss: 128 sss: 32 
0x93429b18932807a6eaf35e3f0584ae2e40eab1e0, 1527, 107, 106, 1, 0, 107, 0, 0, 1.0, 50402, ss: 128 sss: 32 
0x0ac54b299a1a3a67151d7cbefe96ce4f8b2559af, 1235, 88, 87, 1, 0, 88, 0, 0, 1.0, 16108, ss: 128 sss: 32 
0xc235c4afae4272e5a2729cf04eca97d8c470f6ed, 2691, 270, 256, 14, 0, 270, 0, 2, 1.0, 78251, ss: 128 sss: 32 
0xc8a3f5bb7d20677e90f0d1ca2956db41b38b29ed, 1525, 107, 106, 1, 0, 107, 0, 0, 1.0, 29131, ss: 128 sss: 32 
0x102cd29e36cc48e14053bad02cfb7bbf873832d1, 1513, 107, 106, 1, 0, 107, 0, 0, 1.0, 23801, ss: 128 sss: 32 
0x023A0104c45bb4A3f09BeD1214F4e585e88541E5, 2521, 145, 145, 0, 0, 145, 0, 0, 1.0, 292444, ss: 128 sss: 32 
0x35f8cbcf3dca3100af8e50b937b33a7d7649db09, 1643, 115, 114, 1, 0, 115, 0, 0, 1.0, 50682, ss: 128 sss: 32 
0xdDB46Dbd9BC14a05F3d8660578561c4169D7B0fd, 1259, 98, 98, 0, 0, 98, 0, 0, 1.0, 29464, ss: 128 sss: 32 
0xfacd5fc10fbf80427aa2a5317f21096360c9ff8a, 1009, 84, 81, 3, 0, 84, 0, 0, 1.0, 27617, ss: 128 sss: 32 
0x3b6202199934022f307e99440df2405349a98f7e, 2048, 151, 150, 1, 0, 151, 0, 0, 1.0, 67499, ss: 128 sss: 32 
0x9ab795403bf5f4e1e351ad4343c300c29cf5ae15, 1508, 107, 106, 1, 0, 107, 0, 0, 1.0, 59637, ss: 128 sss: 32 
0xb48e327FaB1840196fE161b206FBDC68aC7CE4B6, 2896, 228, 219, 9, 0, 228, 0, 0, 1.0, 47536, ss: 128 sss: 32 
0xbe96c1351902ab7d40b0b4316fd5988b05748700, 1514, 107, 106, 1, 0, 107, 0, 0, 1.0, 63354, ss: 128 sss: 32 
0xa924ca7138d305b74b9e6ee81cae697fa370acaf, 1533, 107, 106, 1, 0, 107, 0, 0, 1.0, 70458, ss: 128 sss: 32 
0x3b760bdb32e557f43baddffee7e6b48876185df6, 1646, 134, 126, 8, 0, 134, 0, 0, 1.0, 18185, ss: 128 sss: 32 
0x8779baf8312337263cc511361a3fb6c6fd67839d, 1839, 134, 132, 2, 0, 134, 0, 0, 1.0, 36060, ss: 128 sss: 32 
0xa33fd66ba90134e0f51414afc169ee96d4b29908, 1518, 107, 106, 1, 0, 107, 0, 0, 1.0, 52426, ss: 128 sss: 32 
0xd5af2e8e896005f92588cbf3dcb1663ce5258734, 1825, 130, 127, 3, 0, 130, 0, 0, 1.0, 27726, ss: 128 sss: 32 
0x6Ee63122d821c36CD9975765a817a3B34700dC23, 1933, 171, 159, 12, 0, 171, 0, 0, 1.0, 66351, ss: 128 sss: 32 
0xcf01a849058633d2925a2e407ec0f0af30120ba8, 2969, 224, 221, 3, 0, 224, 0, 1, 1.0, 78962, ss: 128 sss: 32 
0x51a1bfafacbf7392f0ef891a19fa7071277ccf3c, 2860, 246, 229, 17, 0, 246, 0, 0, 1.0, 134244, ss: 128 sss: 32 
0xAFf4FB92B838FE459c04B301C715886FBd9709c7, 2154, 175, 173, 2, 0, 175, 0, 0, 1.0, 28997, ss: 128 sss: 32 
0x192d61c469772cb16b52d41e337061cbacaaf406, 1519, 107, 106, 1, 0, 107, 0, 0, 1.0, 35591, ss: 128 sss: 32 
0x9c97d7b7c7a591425cee09940de6ca598fdc1f89, 2952, 275, 262, 13, 0, 275, 0, 0, 1.0, 69180, ss: 128 sss: 32 
0xc4300348912a26f304408261c1a322ce0920f2f8, 1481, 103, 103, 0, 0, 103, 0, 0, 1.0, 31874, ss: 128 sss: 32 
0xE520f941def9FeA4BE3e616E8489e2eA1fe23DaB, 980, 71, 69, 2, 0, 71, 0, 0, 1.0, 117467, ss: 128 sss: 32 
0x203bbd2624524b4c20cf964ab04a3cb156adb03f, 1479, 103, 103, 0, 0, 103, 0, 0, 1.0, 73028, ss: 128 sss: 32 
0x4AC38cd5b67F29571fddb2715e28D5277C964469, 2754, 263, 245, 18, 0, 263, 0, 0, 1.0, 56503, ss: 128 sss: 32 
0xc04057cbae8241584f098baed622564e428c7897, 1813, 89, 89, 0, 0, 89, 0, 0, 1.0, 4172, ss: 128 sss: 32 
0x67a6f474a99538c9d8c9259ca6d669fbf33312f7, 1504, 107, 106, 1, 0, 107, 0, 0, 1.0, 31763, ss: 128 sss: 32 
0xf5b45d2f5e5f95c6dc46fd942555b1277735c3cf, 2936, 263, 248, 15, 0, 263, 0, 0, 1.0, 42744, ss: 128 sss: 32 
0x40fB1A1D8da89f1cb65828a5918aCc0D33217482, 2374, 153, 143, 10, 0, 153, 0, 0, 1.0, 7803, ss: 128 sss: 32 
0xcac918DBcE7E08512d90a28Acbd3dc878Bc4b439, 2317, 204, 193, 11, 0, 204, 0, 0, 1.0, 73543, ss: 128 sss: 32 
0x2780af41649c6a8cc4e6efbcd0940efed70da98b, 1486, 103, 103, 0, 0, 103, 0, 0, 1.0, 61602, ss: 128 sss: 32 
0xce6aa7f6d78cfb9673c470b9fd7ed38a6d9fff35, 2033, 92, 92, 0, 0, 92, 0, 0, 1.0, 5695, ss: 128 sss: 32 
0xfdf37696ba7b6f96efda6109fab72a1351c2e33a, 2250, 151, 147, 4, 0, 151, 0, 0, 1.0, 114286, ss: 128 sss: 32 
0xcc97fe0b2f0061d9b09a6abb75f5c2bf2139b296, 1523, 107, 106, 1, 0, 107, 0, 0, 1.0, 51250, ss: 128 sss: 32 
0x1cf5531a46986c8845bad948f5e6058b326f3cfe, 178, 6, 6, 0, 0, 6, 0, 0, 1.0, 44, ss: 128 sss: 32 
0xd5a14d1846de1ad342853b79d1b5ef344c4973ef, 1509, 107, 106, 1, 0, 107, 0, 0, 1.0, 75608, ss: 128 sss: 32 
0x9dad403e285ac9148a0f88ad77c4115eaac3d8ca, 1390, 110, 110, 0, 0, 110, 0, 0, 1.0, 14913, ss: 128 sss: 32 
0x539b1e6ce43d4400926a574241fedc61128a558c, 1024, 84, 81, 3, 0, 84, 0, 0, 1.0, 20347, ss: 128 sss: 32 
0x01fC71D54306bA89C2107cD26c56b9e837f43045, 2372, 220, 205, 15, 0, 220, 0, 0, 1.0, 91146, ss: 128 sss: 32 
0x9397971f4179fa80fb039d038c6956774d65c979, 1031, 84, 81, 3, 0, 84, 0, 0, 1.0, 34305, ss: 128 sss: 32 
0xE7122a9cFf8560F7510CA69A035d5ED59038e4f3, 2964, 275, 262, 13, 0, 275, 0, 0, 1.0, 148431, ss: 128 sss: 32 
0x433df8d74e772f0e875164949a660254507e5ab1, 1530, 107, 106, 1, 0, 107, 0, 0, 1.0, 69240, ss: 128 sss: 32 
0x6e3bd93159a0dd0a819bd7560d482ec37217ad7a, 1003, 100, 96, 4, 0, 100, 0, 0, 1.0, 71401, ss: 128 sss: 32 
0xccfcf6d39745b56dc3536c178c9acdb8dd9e9efd, 1585, 108, 108, 0, 0, 108, 0, 0, 1.0, 26379, ss: 128 sss: 32 
0x13be4811338c9890b1626988c276418e19cbd52b, 1517, 108, 106, 2, 0, 108, 0, 0, 1.0, 31567, ss: 128 sss: 32 
0x224b8cDd157fE44271b34918EE9f62e49e0d6b68, 1680, 135, 129, 6, 0, 135, 0, 0, 1.0, 32463, ss: 128 sss: 32 
0x4798d38df98373ee8474b95f6c9e517d6b81c7bc, 1592, 108, 108, 0, 0, 108, 0, 0, 1.0, 49215, ss: 128 sss: 32 
0xcc0eab15b35cf04b57db2bb1f9237cd782115bdc, 2798, 218, 204, 14, 0, 218, 0, 0, 1.0, 57027, ss: 128 sss: 32 
0xecacb305403ab288b0a2b11d6cd6481de4914b95, 1490, 103, 103, 0, 0, 103, 0, 0, 1.0, 53111, ss: 128 sss: 32 
0xE8E01fCa3A262297CFF5C795D126AA088D65af0A, 1227, 92, 92, 0, 0, 92, 0, 0, 1.0, 23983, ss: 128 sss: 32 
0xfea79db8ed53b7a33887968b77aed28257e0ea59, 1519, 107, 106, 1, 0, 107, 0, 0, 1.0, 46648, ss: 128 sss: 32 
0xf73af3edde6a3231254e3f32c92a03eb28ffd6e7, 1617, 115, 114, 1, 0, 115, 0, 0, 1.0, 54814, ss: 128 sss: 32 
0xfB54b45f332c1131c2b35f86BdF3C8f7394f5E6c, 2942, 274, 256, 18, 0, 274, 0, 0, 1.0, 138460, ss: 128 sss: 32 
0x74BD4109Bd6200fdb04c42d69A3b23d54eBda22a, 2917, 258, 241, 17, 0, 258, 0, 0, 1.0, 87970, ss: 128 sss: 32 
0xc67ae4c367a70cc68fee468a1a3d23296fb9591d, 179, 6, 6, 0, 0, 6, 0, 0, 1.0, 32, ss: 128 sss: 32 
0x4daa178ba35089d965fabb3190db1c3b6ecc2f16, 2780, 231, 213, 18, 0, 231, 0, 0, 1.0, 45475, ss: 128 sss: 32 
0x0502360c2f5d13e485bf2fd098da9cc927edd783, 2309, 175, 168, 7, 0, 175, 0, 0, 1.0, 49408, ss: 128 sss: 32 
0xbe15e5ae5afb304c1e0cfe1d83bb2d519bc3ae87, 1476, 103, 103, 0, 0, 103, 0, 0, 1.0, 65724, ss: 128 sss: 32 
0x7E2aae38d4eC59172018146057793DE445809b23, 2832, 262, 242, 20, 0, 262, 0, 0, 1.0, 26072, ss: 128 sss: 32 
0xc3c3b5157b9fd6c18b0d842be745ff45ed33f79d, 1387, 110, 110, 0, 0, 110, 0, 0, 1.0, 31377, ss: 128 sss: 32 
0x46dd02957b736e4b8c34085eddb628de0d431289, 2254, 151, 147, 4, 0, 151, 0, 0, 1.0, 90944, ss: 128 sss: 32 
0xeea4cda2950d1c28948a804dffedf787cf7f3c18, 1504, 107, 106, 1, 0, 107, 0, 0, 1.0, 66505, ss: 128 sss: 32 
0xb65cec4907647a7f765106ab7008a22e09af3224, 2345, 203, 190, 13, 0, 203, 0, 0, 1.0, 74447, ss: 128 sss: 32 
0xe6ed15cea270cd7ac8f044a4a576b33e00d72379, 1515, 108, 106, 2, 0, 108, 0, 0, 1.0, 31740, ss: 128 sss: 32 
0x598dbb052d87d69b091b509f35036fa18eb6a6fe, 2302, 220, 209, 11, 0, 220, 0, 0, 1.0, 44533, ss: 128 sss: 32 
0x94D37F827740163cb7d939B56aF3B63cDe30B5c8, 2728, 147, 144, 3, 0, 147, 0, 0, 1.0, 270, ss: 128 sss: 32 
0x0594cb5ca47eFE1Ff25C7B8B43E221683B4Db34c, 730, 52, 48, 4, 0, 52, 0, 0, 1.0, 410, ss: 128 sss: 32 
0x82DC2c2467505649E2801868814858D822f1E1Da, 2281, 171, 166, 5, 0, 171, 0, 0, 1.0, 76195, ss: 128 sss: 32 
0x5a235a8B819Bf549AD00e6FcCB07b085CB57a92C, 2966, 275, 262, 13, 0, 275, 0, 0, 1.0, 116445, ss: 128 sss: 32 
0xad197cd527c3bbe1e899bfd7689276a582757290, 2667, 261, 241, 20, 0, 261, 0, 0, 1.0, 129829, ss: 128 sss: 32 
0x3155a180dab61e715faddc9335675da28e38afca, 2535, 115, 110, 5, 0, 115, 0, 0, 1.0, 34651, ss: 128 sss: 32 
0x69d26c4901765ffa6d7716045b680c9574cb00b5, 2707, 190, 188, 2, 0, 190, 0, 1, 1.0, 42149, ss: 128 sss: 32 
0xf79e6b1d44fe2f9a16b1456d652a992690e89453, 1514, 107, 106, 1, 0, 107, 0, 0, 1.0, 36730, ss: 128 sss: 32 
0x3252f6e66790f787df406384cd749a163d21313b, 1601, 110, 110, 0, 0, 110, 0, 0, 1.0, 47726, ss: 128 sss: 32 
0x607b777e4a3c8299cf144b8d9ffbbffc7e2d5f13, 1528, 107, 106, 1, 0, 107, 0, 0, 1.0, 55999, ss: 128 sss: 32 
0x515b315a527edc40d9da03ab1956d230983e928e, 1928, 173, 165, 8, 0, 173, 0, 0, 1.0, 51756, ss: 128 sss: 32 
0x2e27332b25ce245f6628377bc83573a001313c58, 1484, 112, 107, 5, 0, 112, 0, 0, 1.0, 4100, ss: 128 sss: 32 
0xf9694d828a03e6039cbf0959c9268f8ce5dad8d4, 1827, 148, 144, 4, 0, 148, 0, 0, 1.0, 32573, ss: 128 sss: 32 
0x1eA5d0e3b33f5fF94B742Df22F409EA382406B87, 2943, 273, 256, 17, 0, 273, 0, 0, 1.0, 128675, ss: 128 sss: 32 
0xce7c55f268e899aaba3eb28748aa1d6f7f40afb0, 2037, 151, 150, 1, 0, 151, 0, 0, 1.0, 86288, ss: 128 sss: 32 
0x1582ea4267Eacd0A8eC7d47A23A77aefEECbF39D, 2937, 273, 256, 17, 0, 273, 0, 0, 1.0, 73047, ss: 128 sss: 32 
0x59ca804f631edcbfa9da5714e7dc6bcffd78aa32, 2339, 163, 159, 4, 0, 163, 0, 0, 1.0, 74097, ss: 128 sss: 32 
0x39be394ff75dff5a6d20edb662a48a4a57409617, 1633, 114, 113, 1, 0, 114, 0, 0, 1.0, 45190, ss: 128 sss: 32 
0xf79af58431a760a977fe8911a3aef8ecc180d0f7, 1598, 110, 109, 1, 0, 110, 0, 0, 1.0, 23317, ss: 128 sss: 32 
0x7e301a49da1d07e41fa443d77b425910befc26e7, 1544, 115, 114, 1, 0, 115, 0, 0, 1.0, 32192, ss: 128 sss: 32 
0x3f121b9a6bc33b6c9f711ccbcaac67459c875641, 1511, 107, 106, 1, 0, 107, 0, 0, 1.0, 69627, ss: 128 sss: 32 
0x156026b685973e0f0914705c22f2c341c9a79a17, 2856, 247, 233, 14, 0, 247, 0, 0, 1.0, 105484, ss: 128 sss: 32 
0x6e45b69467ec90ea7d221a87994b24306eb59070, 1490, 103, 103, 0, 0, 103, 0, 0, 1.0, 70542, ss: 128 sss: 32 
0xd5f31fc77ff29741511f9388f25886f15a1ef707, 1525, 109, 106, 3, 0, 109, 0, 0, 1.0, 30992, ss: 128 sss: 32 
0x9AB474407776E9739A831D6cC9717020b52a1664, 1315, 87, 87, 0, 0, 87, 0, 0, 1.0, 24906, ss: 128 sss: 32 
0x5687538051928754c38b284540cbd10761e52cba, 1514, 107, 106, 1, 0, 107, 0, 0, 1.0, 53104, ss: 128 sss: 32 
0x92fc983c213b8bfb211f6207f33adfe113328327, 2683, 93, 93, 0, 0, 93, 0, 0, 1.0, 5865, ss: 128 sss: 32 
0xb4741c6000e1785b030f70dde95f3fadbeccaa07, 1225, 87, 87, 0, 0, 87, 0, 0, 1.0, 18425, ss: 128 sss: 32 
0xDC3f0FD59fd0548934A66C873C293fFC300bC15E, 2975, 276, 262, 14, 0, 276, 0, 0, 1.0, 113711, ss: 128 sss: 32 
0xb663945fc96656ad9f5b7ad1561182aca7071592, 1593, 108, 108, 0, 0, 108, 0, 0, 1.0, 64392, ss: 128 sss: 32 
0xfe7103ebca8554740be85317669d5eafbbd7939a, 2437, 179, 178, 1, 0, 179, 0, 0, 1.0, 70587, ss: 128 sss: 32 
0xda024744c5b030ac9ce47dec2347b9e94e896342, 2825, 245, 228, 17, 0, 245, 0, 0, 1.0, 96607, ss: 128 sss: 32 
0x9a94e11834512ba5ecab383be048a27b5af80156, 1525, 107, 106, 1, 0, 107, 0, 0, 1.0, 36298, ss: 128 sss: 32 
0x36a04caffc681fa179558b2aaba30395cddd855f, 2761, 217, 210, 7, 0, 217, 0, 0, 1.0, 175, ss: 128 sss: 32 
0x7d48e1657098df69a36868eeb721c36190320c01, 1516, 107, 106, 1, 0, 107, 0, 0, 1.0, 50541, ss: 128 sss: 32 
0x78e8eebc69179e7c55025a1639633cd5b220accd, 1100, 89, 85, 4, 0, 89, 0, 0, 1.0, 671, ss: 128 sss: 32 
0x57136542BdC53aaf53bF519a6D28A6C8F7CEEB1c, 861, 58, 48, 10, 0, 58, 0, 0, 1.0, 232, ss: 128 sss: 32 
0xb98DB4e50cF9db8096c8690BF81e0655493B8296, 2860, 247, 233, 14, 0, 247, 0, 0, 1.0, 104310, ss: 128 sss: 32 
0x7699B9ACb26b9d05bd9091e14B28Ba57C1F0F5E8, 2527, 115, 110, 5, 0, 115, 0, 0, 1.0, 85229, ss: 128 sss: 32 
0x8ceb642c710d22bd40492a546f12985620b2be4a, 181, 6, 6, 0, 0, 6, 0, 0, 1.0, 40, ss: 128 sss: 32 
0x94e4d8a7dccc8f4956b4706d2a846e1601c420e1, 1011, 84, 81, 3, 0, 84, 0, 0, 1.0, 35051, ss: 128 sss: 32 
0x8bEE4b42a230565dA1bDaEf55F8CEA17f31a7E43, 2884, 259, 253, 6, 0, 259, 0, 0, 1.0, 34298, ss: 128 sss: 32 
0xec4384f90257a1f43bd82deec6ad1b488ebb6d00, 159, 15, 15, 0, 0, 15, 0, 0, 1.0, 74, ss: 128 sss: 32 
0x0c5f7b1fec26f238c18cf3e375ad34210222b8aa, 2533, 246, 230, 16, 0, 246, 0, 0, 1.0, 54641, ss: 128 sss: 32 
0x3c2e869bb072f8d57b7cc8806dc19f71cf8b036e, 1600, 110, 109, 1, 0, 110, 0, 0, 1.0, 46695, ss: 128 sss: 32 
0xbec0ed4a1914d1fb3077d8e1fefb6bf18e77c2dc, 919, 54, 54, 0, 0, 54, 0, 0, 1.0, 2447, ss: 128 sss: 32 
0xfed3d757c5d30382af62bb48c2f7cb7b26675a95, 2328, 205, 195, 10, 0, 205, 0, 0, 1.0, 103553, ss: 128 sss: 32 
0x6368e6512ebf3d07b333868abcf0804398d47a40, 1554, 111, 109, 2, 0, 111, 0, 0, 1.0, 19024, ss: 128 sss: 32 
0xD846AA34caEf083DC4797d75096F60b6E08B7418, 1941, 138, 136, 2, 0, 138, 0, 0, 1.0, 13187, ss: 128 sss: 32 
0x04b2e30960b5d164b55875dedf68784d84c822e3, 1508, 107, 106, 1, 0, 107, 0, 0, 1.0, 51245, ss: 128 sss: 32 
0xd359206f70b7b5586336ceea08e57dc4050241be, 2256, 151, 147, 4, 0, 151, 0, 0, 1.0, 71333, ss: 128 sss: 32 
0x503552D53fd6b378e7f38C7E3A6f00A961162312, 1065, 92, 87, 5, 0, 92, 0, 0, 1.0, 15312, ss: 128 sss: 32 
0x273c8a9ff585cf9033b5588038069f801ed970ca, 1608, 115, 114, 1, 0, 115, 0, 0, 1.0, 31475, ss: 128 sss: 32 
0xf822662479ee7e6f7001443f7efe7a382359d90b, 2508, 172, 166, 6, 0, 172, 0, 0, 1.0, 47968, ss: 128 sss: 32 
0xf57fc9740a308bce89ff591f58672701ea8834dc, 1038, 107, 107, 0, 0, 107, 0, 0, 1.0, 17946, ss: 128 sss: 32 
0x10931db578133ea785f4b1e2c75483a2965170d7, 2524, 177, 173, 4, 0, 177, 0, 0, 1.0, 122473, ss: 128 sss: 32 
0x1c3a52fb6b55ee670d92a41675e24408a305f6ae, 1578, 108, 108, 0, 0, 108, 0, 0, 1.0, 50432, ss: 128 sss: 32 
0xcbbb68ff90efda6bb02095063b1d4864e8dae711, 1521, 107, 106, 1, 0, 107, 0, 0, 1.0, 47094, ss: 128 sss: 32 
0x80550680ec566ec3c222234dc74a78247548fb4e, 1528, 107, 106, 1, 0, 107, 0, 0, 1.0, 44799, ss: 128 sss: 32 
0xa114e8e6d4a237e685e4a125270fcd0a828e831d, 1010, 84, 81, 3, 0, 84, 0, 0, 1.0, 20590, ss: 128 sss: 32 
0x1520a30922096a57bb27bc829185d15c12aa7190, 2416, 226, 215, 11, 0, 226, 0, 0, 1.0, 87167, ss: 128 sss: 32 
0x68fdfd31f11e14f201249ac503f1c856fc1289e0, 2892, 278, 270, 8, 0, 278, 0, 0, 1.0, 119408, ss: 128 sss: 32 
0x3874fccd2775df8495afe7e9667e0805133693df, 1525, 108, 106, 2, 0, 108, 0, 0, 1.0, 74357, ss: 128 sss: 32 
0xda098c1f08d3fceea95b2750e0a1c5af1b4789e5, 2045, 151, 150, 1, 0, 151, 0, 0, 1.0, 36371, ss: 128 sss: 32 
0x42ed2acd9b9c07a3dc984dcde9052afb4eaeb4a6, 1512, 107, 106, 1, 0, 107, 0, 0, 1.0, 50159, ss: 128 sss: 32 
0x4040ef5c870ad5c8085b949027d4391baadc4e92, 2415, 177, 175, 2, 0, 177, 0, 0, 1.0, 59790, ss: 128 sss: 32 
0x1fea1d762adca051ab187082c12c475bdf870976, 1885, 145, 144, 1, 0, 145, 0, 0, 1.0, 40036, ss: 128 sss: 32 
0x17988a539d58e963f34a26bfb3f687010e7a9d52, 1668, 63, 63, 0, 0, 63, 0, 0, 1.0, 5855, ss: 128 sss: 32 
0xf3bed0afafcba68116d6a961885ef323ba1d4be7, 2592, 184, 178, 6, 0, 184, 0, 0, 1.0, 33800, ss: 128 sss: 32 
0x7f212c237699f3244da5ac025e12bcbf00d09357, 1336, 94, 92, 2, 0, 94, 0, 0, 1.0, 38846, ss: 128 sss: 32 
0xb81856fd41f9db8448978de99e44b56140c7eb27, 1513, 107, 106, 1, 0, 107, 0, 0, 1.0, 30984, ss: 128 sss: 32 
0x8a34414ea2146c5c6c3a3e0747441503165eeeaa, 2827, 245, 228, 17, 0, 245, 0, 0, 1.0, 91915, ss: 128 sss: 32 
0x83b79de37c2108ac586ab96aca8ad7c9143c55e9, 1016, 84, 81, 3, 0, 84, 0, 0, 1.0, 36510, ss: 128 sss: 32 
0x3370fb6e762b05877db6c9ed1bf3b2d0a64dc8a0, 1514, 107, 106, 1, 0, 107, 0, 0, 1.0, 27233, ss: 128 sss: 32 
0x3c5590502e366cfd05cddc229205d1cfd9c99aa5, 1385, 110, 110, 0, 0, 110, 0, 0, 1.0, 28201, ss: 128 sss: 32 
0x832d62eeb4e644e4492b44aa023c20e237bfebbb, 2792, 239, 227, 12, 0, 239, 0, 1, 1.0, 34327, ss: 128 sss: 32 
0xb71aacfc5ea13184fda7c64140f7a8e226917ba2, 1433, 136, 121, 15, 0, 136, 0, 0, 1.0, 14543, ss: 128 sss: 32 
0xcAFa681c902B60c62795C3113e7747992CA7D888, 1705, 165, 154, 11, 0, 165, 0, 0, 1.0, 26594, ss: 128 sss: 32 
0xb2517de9d213e42241f2ac1d63400d32bfd1317e, 2756, 263, 245, 18, 0, 263, 0, 0, 1.0, 57072, ss: 128 sss: 32 
0x16569123e2ac740da946be5030d5b3e2457e1fb0, 1503, 110, 109, 1, 0, 110, 0, 0, 1.0, 21137, ss: 128 sss: 32 
0xfa5e41483022b76d4f2414e020c4b6fcdcbb893b, 828, 82, 81, 1, 0, 82, 0, 0, 1.0, 2484, ss: 128 sss: 32 
0xffbb003199F7e44AE520a134590cdfbA2f36f0a1, 2325, 205, 195, 10, 0, 205, 0, 0, 1.0, 83764, ss: 128 sss: 32 
0x7c9751FacbC442A55b180dA29a09595dA49274Aa, 2815, 270, 251, 19, 0, 270, 0, 0, 1.0, 67450, ss: 128 sss: 32 
0x5daa087714cb169f605c673a00aef62a9a7236a6, 1911, 171, 159, 12, 0, 171, 0, 0, 1.0, 34001, ss: 128 sss: 32 
0xB1025b600Eae0373E7761Ab2Fd88c705e2798FA6, 2437, 153, 151, 2, 0, 153, 0, 0, 1.0, 34166, ss: 128 sss: 32 
0xb46b95355932d841893fcb26d0addf220b1cfa1c, 2904, 279, 270, 9, 0, 279, 0, 0, 1.0, 62875, ss: 128 sss: 32 
0xf729ac7de83cead319d60743b128bd3c884e812e, 1098, 111, 110, 1, 0, 111, 0, 0, 1.0, 38981, ss: 128 sss: 32 
0x6D5521F46b2cba9443feFC09cBaC3B15AE0F73eB, 1704, 136, 131, 5, 0, 136, 0, 1, 1.0, 43119, ss: 128 sss: 32 
0xa8a38776e6ae214d94c45a36e6e1b0dc802c09b8, 1513, 107, 106, 1, 0, 107, 0, 0, 1.0, 56498, ss: 128 sss: 32 
0xdee5a9c375cca6b4a4a5e9655cef7136485f31b5, 2462, 170, 163, 7, 0, 170, 0, 0, 1.0, 75916, ss: 128 sss: 32 
0x9248679610d7a502a069948278160c88239f123b, 1518, 107, 106, 1, 0, 107, 0, 0, 1.0, 73052, ss: 128 sss: 32 
0x98409aB93f0530556bCd99936E2787e50Bb70E06, 2135, 195, 183, 12, 0, 195, 0, 0, 1.0, 42595, ss: 128 sss: 32 
0xe0D4C3666cf447918a3761d6307EC7e79d48F74b, 2251, 171, 169, 2, 0, 171, 0, 0, 1.0, 34703, ss: 128 sss: 32 
0xe644345e352805198a7f66a629c0076990a5edaf, 1515, 107, 106, 1, 0, 107, 0, 0, 1.0, 33477, ss: 128 sss: 32 
0x4096dc8773b8d8c4a4146f8d4295d4a1bddaab25, 664, 28, 28, 0, 0, 28, 0, 0, 1.0, 157, ss: 128 sss: 32 
0xb6138b0a747858d96d373dfd48f5aed6e0a88a18, 1514, 107, 106, 1, 0, 107, 0, 0, 1.0, 47285, ss: 128 sss: 32 
0x7a6709cbb7b3340b32c5007ac0a26053a4ae2adb, 1340, 94, 92, 2, 0, 94, 0, 0, 1.0, 20966, ss: 128 sss: 32 
0x1f8819d37a1bed5e2ec759e041234373b19b2bfe, 1508, 107, 106, 1, 0, 107, 0, 0, 1.0, 34970, ss: 128 sss: 32 
0x08dbc7a342c5e17cfbf610b4ed3320cdf6ca0f5b, 1210, 86, 84, 2, 0, 86, 0, 0, 1.0, 8889, ss: 128 sss: 32 
0x368457ec2c9096b9ae9e30af1b20aa16ce422930, 425, 36, 36, 0, 0, 36, 0, 0, 1.0, 63, ss: 128 sss: 32 
0xabf1c54c4432009f13f0ee26743d9bb83b5f96e5, 1548, 115, 114, 1, 0, 115, 0, 0, 1.0, 34184, ss: 128 sss: 32 
0x5cd21eba15cc71714c374da86b5308493f7a256a, 1575, 103, 103, 0, 0, 103, 0, 0, 1.0, 38421, ss: 128 sss: 32 
0x5b7279055048d435d70e86be71764de0a09e5b7f, 1489, 103, 103, 0, 0, 103, 0, 0, 1.0, 74024, ss: 128 sss: 32 
0xa8e47db4ccf28475e1970e13303ba1d62c779d0c, 1522, 107, 106, 1, 0, 107, 0, 0, 1.0, 67823, ss: 128 sss: 32 
0x13b385a0cbc3296f14b342bad0e4fdf91ee08100, 2621, 187, 178, 9, 0, 187, 0, 0, 1.0, 32118, ss: 128 sss: 32 
0xdd4a8d04fcca1ad84be9b5801c95f9a4dc49b6a6, 1513, 108, 106, 2, 0, 108, 0, 0, 1.0, 69260, ss: 128 sss: 32 
0x58b7aac44d4c448cdfd712892989acaee126d2bc, 1524, 108, 106, 2, 0, 108, 0, 0, 1.0, 35108, ss: 128 sss: 32 
0x4927a646dec1cf59b69f4912331e5fa97807f00b, 1506, 107, 106, 1, 0, 107, 0, 0, 1.0, 56822, ss: 128 sss: 32 
0xc9097f9df7b07b0587f1745d045df47994647719, 1216, 87, 87, 0, 0, 87, 0, 0, 1.0, 14064, ss: 128 sss: 32 
0xca8bbf967e3c133a08f2add9e1dfd56e86a51958, 1612, 115, 114, 1, 0, 115, 0, 0, 1.0, 44676, ss: 128 sss: 32 
0x00e1e1CBf51ff492C4178828008fa9381a4415c3, 1851, 158, 155, 3, 0, 158, 0, 0, 1.0, 59746, ss: 128 sss: 32 
0xa324008d7e4492d662f66f9b34825f65a4fb27b1, 2873, 276, 264, 12, 0, 276, 0, 0, 1.0, 171401, ss: 128 sss: 32 
0xb215f66588dfcc85d93a4770ad11c94578be229f, 1516, 107, 106, 1, 0, 107, 0, 0, 1.0, 53345, ss: 128 sss: 32 
0x10cf4547763e436991bae0bb23286ec1bb6a9ce2, 66, 6, 5, 1, 0, 6, 0, 0, 1.0, 26, ss: 128 sss: 32 
0x298fabd16314e017fd67df916191ad23742a1ab7, 1581, 103, 103, 0, 0, 103, 0, 0, 1.0, 31127, ss: 128 sss: 32 
0xe846ec7087f879d7e08603696b2e8f2d706a0b51, 1478, 103, 103, 0, 0, 103, 0, 0, 1.0, 31846, ss: 128 sss: 32 
0x14194dde9914bc05964dc2f61ed2dbf9e85986cb, 1476, 108, 107, 1, 0, 108, 0, 0, 1.0, 24114, ss: 128 sss: 32 
0x65e3214e1fb76e50b15c9032eba75a7441844cfd, 1030, 101, 101, 0, 0, 101, 0, 0, 1.0, 25319, ss: 128 sss: 32 
0xd4e95da59f7595f93e3f3b7a44285b98f10f5a73, 1644, 116, 114, 2, 0, 116, 0, 0, 1.0, 62618, ss: 128 sss: 32 
0x38d7c6bdcd980e6f28db2d73275096cb500a5bbc, 2835, 221, 206, 15, 0, 221, 0, 0, 1.0, 79989, ss: 128 sss: 32 
0xc053308c25597ac6447ccfbf25bb08bfdf03b596, 1355, 84, 81, 3, 0, 84, 0, 0, 1.0, 28139, ss: 128 sss: 32 
0xf20628293fa6b65501c173c34f8a2aea92830682, 2384, 207, 203, 4, 0, 207, 0, 0, 1.0, 55309, ss: 128 sss: 32 
0x5fba3418eac88fa98b38f9306dbde78ef811f2d2, 2161, 197, 189, 8, 0, 197, 0, 0, 1.0, 57501, ss: 128 sss: 32 
0x03d62c277855ef95af078c709800c1d51c3c027c, 1503, 107, 106, 1, 0, 107, 0, 0, 1.0, 47443, ss: 128 sss: 32 
0x0ce92e58e79594b39eaf5a594820b74df3317fd8, 2157, 178, 175, 3, 0, 178, 0, 1, 1.0, 42290, ss: 128 sss: 32 
0x84aE6D61Df5c6ba7196b5C76Bcb112B8a689aD37, 1889, 116, 112, 4, 0, 116, 0, 0, 1.0, 10810, ss: 128 sss: 32 
0x6AEFD8d13D3D28709eA1Ee9A0DB0C3654DCebA8c, 2531, 116, 110, 6, 0, 116, 0, 0, 1.0, 34263, ss: 128 sss: 32 
0x2172be858cd9703cfa4c1da64a323eac5ba96b49, 1392, 110, 110, 0, 0, 110, 0, 0, 1.0, 24953, ss: 128 sss: 32 
0x9599b3525d9becd6425dee1caafb9de5f8f95e2c, 1614, 115, 113, 2, 0, 115, 0, 0, 1.0, 34291, ss: 128 sss: 32 
0xc862346614d4af4c0a3dff74cebf5a33f188ae73, 1484, 103, 103, 0, 0, 103, 0, 0, 1.0, 58986, ss: 128 sss: 32 
0x43a894336D23c2C79A958638e2c23C81AE4a9F96, 181, 8, 6, 2, 0, 8, 0, 0, 1.0, 7, ss: 128 sss: 32 
0xae21d99a0f223945a50d432c8fcd29f5834f00cb, 1826, 89, 89, 0, 0, 89, 0, 0, 1.0, 3299, ss: 128 sss: 32 
0x7e5d4877f12db6ee7b524dc24b34733427ce6991, 1164, 114, 101, 13, 0, 114, 0, 0, 1.0, 9252, ss: 128 sss: 32 
0x00fc332cd9fd3d8a59b5c7d4a0f367da5d391b0d, 2887, 278, 270, 8, 0, 278, 0, 0, 1.0, 171985, ss: 128 sss: 32 
0x3f605f6d76cab5e5c1dc60857f1bb17e27a6dc23, 2037, 162, 149, 13, 0, 162, 0, 0, 1.0, 23425, ss: 128 sss: 32 
0x661b386cd67ac268457cd22b80b2c685cf9b40cf, 2253, 151, 147, 4, 0, 151, 0, 0, 1.0, 77584, ss: 128 sss: 32 
0x375f842b65e5baa2d1ae9a99069d8f5e3bda94cb, 2047, 151, 150, 1, 0, 151, 0, 0, 1.0, 82579, ss: 128 sss: 32 
0x718495979a46918f6f32bebaeab69965376bcc32, 1295, 83, 83, 0, 0, 83, 0, 0, 1.0, 26268, ss: 128 sss: 32 
0x43882C864a406D55411b8C166bCA604709fDF624, 730, 52, 48, 4, 0, 52, 0, 0, 1.0, 480, ss: 128 sss: 32 
0xaad9508a5daa4e0175c27a57d328665f83ee9887, 2629, 106, 106, 0, 0, 106, 0, 0, 1.0, 13640, ss: 128 sss: 32 
0xDf00fD89Aa8653AaAa8DCc011d02c355CDd5aFF1, 2841, 245, 228, 17, 0, 245, 0, 0, 1.0, 125399, ss: 128 sss: 32 
0x524ec1b206100c5ecd1142dfb52e78cd3f47db73, 2925, 263, 248, 15, 0, 263, 0, 0, 1.0, 64369, ss: 128 sss: 32 
0x713708fd0787f10355d683b8634b88342e2b9b17, 2059, 151, 150, 1, 0, 151, 0, 0, 1.0, 70359, ss: 128 sss: 32 
0xbcb9984758367e1d7d1e8784630ba41463a425e0, 1502, 103, 103, 0, 0, 103, 0, 0, 1.0, 58245, ss: 128 sss: 32 
0x10e533be02b57fe9448098e0cd8a728c64a67b2c, 1567, 103, 103, 0, 0, 103, 0, 0, 1.0, 42720, ss: 128 sss: 32 
0xe3692b2E55Eb2494cA73610c3b027F53815CCD39, 1557, 120, 110, 10, 0, 120, 0, 1, 1.0, 6144, ss: 128 sss: 32 
0x283d623967c180f535c091ad07b8db45b02c3da8, 1502, 111, 110, 1, 0, 111, 0, 0, 1.0, 29398, ss: 128 sss: 32 
0x3b7c618156f8cef53e123a66166aaf915b30ba3e, 1644, 114, 112, 2, 0, 114, 0, 0, 1.0, 31958, ss: 128 sss: 32 
0xe29a3e5f63716710a24a0d4d1a2d30a7dac49e60, 2953, 276, 262, 14, 0, 276, 0, 0, 1.0, 96029, ss: 128 sss: 32 
0x7cac08a466cf98434f182c5ed47929fa21c6b946, 1528, 108, 106, 2, 0, 108, 0, 0, 1.0, 31010, ss: 128 sss: 32 
0x10a43a9f52da81a7d545f430aed4c44836ce56cb, 1525, 107, 106, 1, 0, 107, 0, 0, 1.0, 31788, ss: 128 sss: 32 
0xdf494fd1f3a3377016539ed891b5d5deeb278eb8, 1596, 108, 108, 0, 0, 108, 0, 0, 1.0, 48476, ss: 128 sss: 32 
0xfac029ea44a022f49c76196c1c9c522b102b367b, 1509, 107, 106, 1, 0, 107, 0, 0, 1.0, 55236, ss: 128 sss: 32 
0xdab486824c4a98a21325a34a36ed95085ad7442e, 1586, 108, 108, 0, 0, 108, 0, 0, 1.0, 53560, ss: 128 sss: 32 
0xbb9d01f1e69b7abfec0c429ac47ce3dd858322bd, 1513, 107, 106, 1, 0, 107, 0, 0, 1.0, 64509, ss: 128 sss: 32 
0x8b0c332DDcdd8aC8155972d19f43C718F5D50a1f, 2993, 225, 222, 3, 0, 225, 0, 1, 1.0, 89582, ss: 128 sss: 32 
0x2063516ba30d69f9075854a9f57d9c29f0c61b59, 2731, 210, 201, 9, 0, 210, 0, 0, 1.0, 32639, ss: 128 sss: 32 
0x44214aaca0a71cfd5918eeaffcfb3ec026ee7ec3, 1838, 89, 89, 0, 0, 89, 0, 0, 1.0, 3230, ss: 128 sss: 32 
0x65dab4bbc46a1cb270f333abe025eb1d82211f92, 1523, 108, 106, 2, 0, 108, 0, 0, 1.0, 32990, ss: 128 sss: 32 
0x0D374775E962c3608B8F0A4b8B10567DF739bb56, 730, 52, 48, 4, 0, 52, 0, 0, 1.0, 469, ss: 128 sss: 32 
0xfa0460097248642d69bfb223bab5999507a8c23d, 1528, 107, 106, 1, 0, 107, 0, 0, 1.0, 74234, ss: 128 sss: 32 
0xff80acfd798fc49a40dcc9d3eadc2cce628bc6f9, 1511, 107, 106, 1, 0, 107, 0, 0, 1.0, 27918, ss: 128 sss: 32 
0x6ed79dc61e5d99ce733edb55d83e42b94eea72b9, 1038, 84, 81, 3, 0, 84, 0, 0, 1.0, 26108, ss: 128 sss: 32 
0xafcf906323c0ab55a081ed019f9b0c57a20548e6, 1511, 107, 106, 1, 0, 107, 0, 0, 1.0, 33322, ss: 128 sss: 32 
0xf1B59868697f3925b72889ede818B9E7ba0316d0, 1344, 109, 109, 0, 0, 109, 0, 0, 1.0, 8002, ss: 128 sss: 32 
0x41981ede05f4c7e608ca37df89e57881d585a7fc, 1341, 118, 114, 4, 0, 118, 0, 0, 1.0, 42656, ss: 128 sss: 32 
0x3b400259B6E8D003C9973a79Fb9828fBA9Fb87a0, 167, 8, 6, 2, 0, 8, 0, 0, 1.0, 19, ss: 128 sss: 32 
0x21e3098a0dae6451458681c516e1243ce05c7718, 1392, 101, 98, 3, 0, 101, 0, 0, 1.0, 17222, ss: 128 sss: 32 
0x908c532204d8e6087889bb774f062b9c6edeb4ee, 2870, 246, 229, 17, 0, 246, 0, 0, 1.0, 121156, ss: 128 sss: 32 
0x5e314e43426a74f1f8275aaff30f41acf988b880, 1215, 87, 87, 0, 0, 87, 0, 0, 1.0, 16509, ss: 128 sss: 32 
0xED9d16a9c15B47904F535abBFff3DAa2113dB560, 1490, 115, 115, 0, 0, 115, 0, 0, 1.0, 17727, ss: 128 sss: 32 
0xba5f9b4522a6d17fb1fd64999651cf7bd432cd4b, 2430, 217, 197, 20, 0, 217, 0, 0, 1.0, 79088, ss: 128 sss: 32 
0xcf6f65b8925b73d0289bf9c7f088dd57a8040629, 2667, 258, 236, 22, 0, 258, 0, 0, 1.0, 114806, ss: 128 sss: 32 
0x9f69ef68866ce4f74139ef9b134d3d3c2f0794f6, 1491, 103, 103, 0, 0, 103, 0, 0, 1.0, 48189, ss: 128 sss: 32 
0x8bc05be3eb4a617b2ff5156e4afc42a085ccd5c8, 1873, 120, 118, 2, 0, 120, 0, 0, 1.0, 28406, ss: 128 sss: 32 
0xCA1C3102fEfC56F5B4E3B98cC743281F71f17712, 2018, 163, 156, 7, 0, 163, 0, 0, 1.0, 42157, ss: 128 sss: 32 
0xc9e358259e325bcb96abe0eeebeddc46559ac20c, 2681, 93, 93, 0, 0, 93, 0, 0, 1.0, 12097, ss: 128 sss: 32 
0x0d963931e5e081e6d355c0ae360b437955fd9a46, 1378, 99, 98, 1, 0, 99, 0, 0, 1.0, 33784, ss: 128 sss: 32 
0x1af81831e535824ac4bb0b70296d10268e1d8a47, 1513, 107, 106, 1, 0, 107, 0, 0, 1.0, 47648, ss: 128 sss: 32 
0x934b015e56b12a69f8d2172c6fac9bc010c43330, 1519, 107, 106, 1, 0, 107, 0, 0, 1.0, 34795, ss: 128 sss: 32 
0x3ffCb18bAaC609754e8BD81B7Be618AA1300B841, 1568, 104, 103, 1, 0, 104, 0, 0, 1.0, 37457, ss: 128 sss: 32 
0xafbC193c9eEf98b6EF317ad0C202F3324b777033, 2027, 176, 175, 1, 0, 176, 0, 0, 1.0, 34534, ss: 128 sss: 32 
0xd84622b0d4c7a8dea25c7698396b51dfc8abd905, 1525, 107, 106, 1, 0, 107, 0, 0, 1.0, 51664, ss: 128 sss: 32 
0xb3168eafb615b5a0870725dc07d9b4e671d411fc, 1539, 107, 106, 1, 0, 107, 0, 0, 1.0, 29967, ss: 128 sss: 32 
0x3b0a89c3a23df630dd956c96405f6cb7905db9ab, 2308, 220, 209, 11, 0, 220, 0, 0, 1.0, 89414, ss: 128 sss: 32 
0xa1a7cc46d48f895f4c6a0274e30e50ebf64d564d, 1913, 147, 147, 0, 0, 147, 0, 0, 1.0, 21076, ss: 128 sss: 32 
0xc891738d5bd1b9b86b5b18839add3621de8b05fd, 240, 11, 11, 0, 0, 11, 0, 0, 1.0, 31, ss: 128 sss: 32 
0xb0990e799314c516060b67a030fa5f5318baab69, 1673, 119, 118, 1, 0, 119, 0, 0, 1.0, 33740, ss: 128 sss: 32 
0x778c53b8b7c81617e333b378fc4e4a7f056e6947, 2833, 245, 228, 17, 0, 245, 0, 0, 1.0, 93928, ss: 128 sss: 32 
0xcba80259375e72f441ba4febdb9099483cc0157b, 1625, 115, 114, 1, 0, 115, 0, 0, 1.0, 65991, ss: 128 sss: 32 
0xeb3d1c8e8e98b46f2efceabd0f4ade07fcb1099f, 2432, 179, 178, 1, 0, 179, 0, 0, 1.0, 52100, ss: 128 sss: 32 
0xdc4a0fd308b188accde2dddc03d6dc468d099260, 1395, 109, 107, 2, 0, 109, 0, 0, 1.0, 25456, ss: 128 sss: 32 
0x17e713f4757fc30b99d18f1a0658470d117d8d05, 1594, 110, 109, 1, 0, 110, 0, 0, 1.0, 30638, ss: 128 sss: 32 
0x1e0fec97b98687cc4bbf1592484cade9de65f291, 2899, 248, 235, 13, 0, 248, 0, 0, 1.0, 123045, ss: 128 sss: 32 
0x7521febce25fe0a8b0991b8dbf085d31c4e5b65b, 1515, 107, 106, 1, 0, 107, 0, 0, 1.0, 35107, ss: 128 sss: 32 
0x2d9ABd5e44B30a1bc06ce4f74F8f0442f77cf214, 2956, 275, 262, 13, 0, 275, 0, 0, 1.0, 119103, ss: 128 sss: 32 
0xf72437b66790fa5b7d3fa9b726f4d8e77e70b064, 1527, 107, 106, 1, 0, 107, 0, 0, 1.0, 66288, ss: 128 sss: 32 
0x528a7d60daf08a98e39220b1de6557be6afe9bbb, 715, 70, 70, 0, 0, 70, 0, 0, 1.0, 1881, ss: 128 sss: 32 
0x83b80597bfd841fecaa31ff078e26ba7a45414a1, 2114, 149, 146, 3, 0, 149, 0, 0, 1.0, 59228, ss: 128 sss: 32 
0x98b39E67F63E89C3CbbEb8EdED75374C906a1912, 1316, 87, 87, 0, 0, 87, 0, 0, 1.0, 48598, ss: 128 sss: 32 
0x6141fbaa54b209bcb2d1d667bc3ca074c790941f, 1376, 99, 98, 1, 0, 99, 0, 0, 1.0, 39763, ss: 128 sss: 32 
0x645722Ff041bC6C00494dB65Dcd2907dc13a3F50, 2160, 175, 173, 2, 0, 175, 0, 0, 1.0, 25230, ss: 128 sss: 32 
0xcb298bfcd4c5fc8b3da648d667d374e61e3e3d28, 1360, 96, 95, 1, 0, 96, 0, 0, 1.0, 20555, ss: 128 sss: 32 
0xae427eb0bec7ad2ef79d1ae2a26b71d23ac81da0, 2571, 198, 196, 2, 0, 198, 0, 0, 1.0, 62800, ss: 128 sss: 32 
0x4096acdc3bb3c6a8bdd70a946515a07b465232c0, 1596, 110, 109, 1, 0, 110, 0, 0, 1.0, 23508, ss: 128 sss: 32 
0xb23a03f2ea4a7d6929fd4b063e8e60c8fed1cdc5, 1564, 108, 107, 1, 0, 108, 0, 0, 1.0, 43804, ss: 128 sss: 32 
0x0a442ac10830f98e6f0485c6193490c5260e94b8, 2850, 247, 234, 13, 0, 247, 0, 0, 1.0, 140509, ss: 128 sss: 32 
0x125887Cd1Fa149067606E8a3B58189Bfc085567B, 2938, 273, 256, 17, 0, 273, 0, 0, 1.0, 60917, ss: 128 sss: 32 
0x058ca96e3235c6a3aeae90a89de884817004eac9, 1519, 107, 106, 1, 0, 107, 0, 0, 1.0, 34697, ss: 128 sss: 32 
0x75b884711094aa9f407251892d28653d049fafbd, 1508, 107, 106, 1, 0, 107, 0, 0, 1.0, 76241, ss: 128 sss: 32 
0x44846b0ba090413bd9781237ce03f9a166a155f1, 1357, 96, 95, 1, 0, 96, 0, 0, 1.0, 22336, ss: 128 sss: 32 
0x714b47510a3dC2285ddAb567Cff57F23FE6690FF, 2385, 220, 205, 15, 0, 220, 0, 0, 1.0, 83515, ss: 128 sss: 32 
0xa19a0ece8e0f26857a8c85d52682072ce54a6b4b, 1504, 107, 106, 1, 0, 107, 0, 0, 1.0, 43679, ss: 128 sss: 32 
0x7c032115bc32e118f7652411277d434ed1a2e120, 1385, 110, 110, 0, 0, 110, 0, 0, 1.0, 34840, ss: 128 sss: 32 
0x62272320b66a5fc51d029b2382691d6439d3bd2c, 1542, 115, 114, 1, 0, 115, 0, 0, 1.0, 38158, ss: 128 sss: 32 
0x0bdcbcee099bd7d940d6138c4af15c7e41ad6900, 2422, 227, 215, 12, 0, 227, 0, 0, 1.0, 70719, ss: 128 sss: 32 
0xb7a9bf4847723e620ca8bc818084c5adca911268, 1692, 170, 162, 8, 0, 170, 0, 0, 1.0, 32978, ss: 128 sss: 32 
0x12b7839faba2da9aa079450ec7c228fb9ea9479a, 1624, 115, 114, 1, 0, 115, 0, 0, 1.0, 47117, ss: 128 sss: 32 
0x96d1f6eaa5a52b2eac0579be197bf519f2f05aa7, 1552, 103, 103, 0, 0, 103, 0, 0, 1.0, 21835, ss: 128 sss: 32 
0x714f39713db1a1d40a9197bf56be59d214086500, 1527, 107, 106, 1, 0, 107, 0, 0, 1.0, 54899, ss: 128 sss: 32 
0x0eba910497ba4ca01e691d9bfe6823d8ec3457f5, 1591, 107, 106, 1, 0, 107, 0, 0, 1.0, 23527, ss: 128 sss: 32 
0x5fa8dd02b3dd12680035baef2938a0edb5147a3f, 1527, 107, 106, 1, 0, 107, 0, 0, 1.0, 31058, ss: 128 sss: 32 
0x7ad147907847953492450f099f52f1de0e1113d1, 1517, 107, 106, 1, 0, 107, 0, 0, 1.0, 31601, ss: 128 sss: 32 
0x4939FDF31F6753E1600307e50ADA499375361FC9, 2025, 164, 163, 1, 0, 164, 0, 0, 1.0, 31590, ss: 128 sss: 32 
0x01e7a3829eab007c79b2e49b009217ac94fcea6d, 1184, 98, 95, 3, 0, 98, 0, 0, 1.0, 16310, ss: 128 sss: 32 
0xf6f8d792653a869b0da34b11ef30cb3c1bd91767, 1628, 115, 114, 1, 0, 115, 0, 0, 1.0, 55084, ss: 128 sss: 32 
0x852256a6d44db02548a970019a8b7b12969cc60b, 1521, 108, 106, 2, 0, 108, 0, 0, 1.0, 61074, ss: 128 sss: 32 
0x5d02e188D7A922513F14b69D71af77c3B0Bc0551, 2535, 115, 110, 5, 0, 115, 0, 0, 1.0, 29310, ss: 128 sss: 32 
0xc40eDd689468692B29bC4Cf0d87265bD3FEa085B, 2957, 275, 262, 13, 0, 275, 0, 0, 1.0, 121772, ss: 128 sss: 32 
0xfb5Bc0af330e64964210f148C8B06fde190565Cd, 1898, 144, 136, 8, 0, 144, 0, 0, 1.0, 99844, ss: 128 sss: 32 
0x306c0b64c39fb8924b026f6b9418d38278fc3c3f, 1402, 111, 110, 1, 0, 111, 0, 0, 1.0, 35085, ss: 128 sss: 32 
0x4056ca64d156a6c9909c332817baa6024add551b, 1520, 108, 106, 2, 0, 108, 0, 0, 1.0, 32499, ss: 128 sss: 32 
0xf518c72caa778ba9757b37b043a2c81e06e6ea7f, 470, 40, 40, 0, 0, 40, 0, 0, 1.0, 173, ss: 128 sss: 32 
0x2dac7f83f8098a0d5cf86d79eaf2d79cf74989e2, 1524, 107, 106, 1, 0, 107, 0, 0, 1.0, 76246, ss: 128 sss: 32 
0x8cb1eb763a3febad7ae9d72b6dcd97dd90ad2189, 2838, 245, 228, 17, 0, 245, 0, 0, 1.0, 102430, ss: 128 sss: 32 
0x97a206f60438e92da0807b1c3182c390849f6b3d, 1249, 96, 96, 0, 0, 96, 0, 0, 1.0, 21972, ss: 128 sss: 32 
0xff98e5581a5fe85c1c34222917de7522c87e40a1, 1623, 113, 112, 1, 0, 113, 0, 0, 1.0, 36744, ss: 128 sss: 32 
0x905ade25B1f8f39Cf470E39c5A768EAF1f91Fd3e, 1125, 70, 62, 8, 0, 70, 0, 0, 1.0, 33633, ss: 128 sss: 32 
0x719cf1156a52686d08b0b98ffc518f641845c568, 1521, 107, 106, 1, 0, 107, 0, 0, 1.0, 65274, ss: 128 sss: 32 
0x5Ba19d2592d00Cf075f18Cd01aEa7f5e79c4d5b3, 2394, 225, 212, 13, 0, 225, 0, 0, 1.0, 60260, ss: 128 sss: 32 
0x153b5b235717354e2a8c3a19a0af26128a142d59, 1503, 136, 125, 11, 0, 136, 0, 0, 1.0, 9564, ss: 128 sss: 32 
0x6c11ccf62Ba347549eAD21A3390DFa43ea238D78, 1016, 84, 81, 3, 0, 84, 0, 0, 1.0, 15760, ss: 128 sss: 32 
0xfc115de8ec72eb71cb18482b3ba5b36c01928bec, 2580, 255, 244, 11, 0, 255, 0, 2, 1.0, 101190, ss: 128 sss: 32 
0x05b2c0c67c3384b831a56d48f8aca588c566b8dd, 1007, 84, 81, 3, 0, 84, 0, 0, 1.0, 27124, ss: 128 sss: 32 
0x9a0E53ED366fF1CBb13Ac179887B6b9A2deb9c51, 2012, 143, 142, 1, 0, 143, 0, 0, 1.0, 33749, ss: 128 sss: 32 
0x5FC6b84f877B9FFF371950e3e825AC182f3d398d, 2906, 176, 175, 1, 0, 176, 0, 0, 1.0, 285463, ss: 128 sss: 32 
0x09be35e457496fc12e10b24dbb6f807e59f261dd, 1929, 173, 165, 8, 0, 173, 0, 0, 1.0, 71227, ss: 128 sss: 32 
0x3fc2d13e0aed7477d87e6b566ae50b627029ff3c, 1508, 107, 106, 1, 0, 107, 0, 0, 1.0, 52944, ss: 128 sss: 32 
0xd4c89791ef0fade72eaac6475296320b5572b28e, 1427, 88, 81, 7, 0, 88, 0, 0, 1.0, 5987, ss: 128 sss: 32 
0x8fdaacb3d649d4d831576c7590b795c915b2144a, 2422, 226, 215, 11, 0, 226, 0, 0, 1.0, 85122, ss: 128 sss: 32 
0xd6c107dc8b4926fc1eb6c4c9b1c19e529b35c713, 2892, 278, 270, 8, 0, 278, 0, 0, 1.0, 110382, ss: 128 sss: 32 
0x5aA86e9558F7701A90f343D90e0bC55AEb0046Df, 2748, 177, 164, 13, 0, 177, 0, 0, 1.0, 14170, ss: 128 sss: 32 
0x450b1e227c0264ea02cf86e40cd557789dafdfc4, 1512, 107, 106, 1, 0, 107, 0, 0, 1.0, 57364, ss: 128 sss: 32 
0x104462e4f7263cd7751e22d10ec5b1e5ccaf0276, 2074, 192, 179, 13, 0, 192, 0, 0, 1.0, 59263, ss: 128 sss: 32 
0xfaed839b7342535fb86def6a80ad30c826ea2a98, 1512, 107, 106, 1, 0, 107, 0, 0, 1.0, 47627, ss: 128 sss: 32 
0x77ffef9c26223cebb46105b1433a77114a9a10b6, 1513, 107, 106, 1, 0, 107, 0, 0, 1.0, 49530, ss: 128 sss: 32 
0x5593f2f61E772d6153d0Eb9a2F0F51Bba7DCAB8a, 1902, 139, 137, 2, 0, 139, 0, 0, 1.0, 3890, ss: 128 sss: 32 
0xa10edb510cf7714cbe2a7fb907385561db0b8c37, 2826, 253, 234, 19, 0, 253, 0, 0, 1.0, 82092, ss: 128 sss: 32 
0xC00DF57B3f0b80B58205627Bb1D2cD431c49e1A0, 2642, 209, 208, 1, 0, 209, 0, 0, 1.0, 192541, ss: 128 sss: 32 
0x3145a839da643bd2a8b5af0a03f1c5ca2fcc7862, 668, 55, 55, 0, 0, 55, 0, 0, 1.0, 3047, ss: 128 sss: 32 
0xff0f003cE5cAc5935e0f4a33A409fB5Db24F2152, 2335, 205, 195, 10, 0, 205, 0, 0, 1.0, 69749, ss: 128 sss: 32 
0x0d283045243db55181c01236339ba357b54ecb87, 1520, 107, 106, 1, 0, 107, 0, 0, 1.0, 31413, ss: 128 sss: 32 
0x45c08c9B749b53d2C941Bb31Eb61d227abA72E57, 2427, 205, 197, 8, 0, 205, 0, 1, 1.0, 34428, ss: 128 sss: 32 
0x5b9c61e4f7add807c2127fb744315b302d80546a, 1515, 107, 106, 1, 0, 107, 0, 0, 1.0, 44987, ss: 128 sss: 32 
0xFB1a5044C241EdD9896a546a9df55683bea5CF82, 2868, 248, 223, 25, 0, 248, 0, 0, 1.0, 60473, ss: 128 sss: 32 
0x32a37a9d8a049e766075b567ec813994e8a934ff, 2414, 226, 215, 11, 0, 226, 0, 0, 1.0, 52013, ss: 128 sss: 32 
0xfb5b06d024ca8744ac4da22e8aa8173cf07c27bc, 1513, 107, 106, 1, 0, 107, 0, 0, 1.0, 65533, ss: 128 sss: 32 
0xef0091ADE4E6b3438077aBa1888cFcA7AD7d1855, 2327, 205, 195, 10, 0, 205, 0, 0, 1.0, 45492, ss: 128 sss: 32 
0xF811580Cf0c6B4503652dF726f13b0aea84DF050, 1195, 119, 102, 17, 0, 119, 0, 0, 1.0, 2081, ss: 128 sss: 32 
0xE1b45a7FB3643e14e297f915789e24CE7C3Fd19F, 2418, 177, 177, 0, 0, 177, 0, 0, 1.0, 527170, ss: 128 sss: 32 
0x94c4B61EC63Ba1Bfea60a46f4c4e890B1d7e6FF5, 1111, 117, 116, 1, 0, 117, 0, 0, 1.0, 45442, ss: 128 sss: 32 
0xeef45721f10d3b67008152350328154efa7cde8e, 2819, 124, 120, 4, 0, 124, 0, 0, 1.0, 110698, ss: 128 sss: 32 
0xfdf2239453185f15374bc54a4737bab22720acf7, 1382, 110, 110, 0, 0, 110, 0, 0, 1.0, 28267, ss: 128 sss: 32 
0xc8a8efea810c1ee79d8669653d17d9de7c22ad30, 1900, 147, 147, 0, 0, 147, 0, 0, 1.0, 47081, ss: 128 sss: 32 
0x160ed9a82bde7ef06308fdfc96a7ed35bb6dcdd1, 2045, 151, 150, 1, 0, 151, 0, 0, 1.0, 68858, ss: 128 sss: 32 
0xe536920e8256d58Ca9356899bcc36C4F14E76a2c, 2937, 273, 256, 17, 0, 273, 0, 0, 1.0, 134435, ss: 128 sss: 32 
0x360e7e819073777c6802255aff8a9ac2953a58f3, 1510, 107, 106, 1, 0, 107, 0, 0, 1.0, 32188, ss: 128 sss: 32 
0xbc26e7898bac2af02e19f2c9901ab0d7f72ae64b, 1515, 107, 106, 1, 0, 107, 0, 0, 1.0, 49143, ss: 128 sss: 32 
0xB138084CfDDDE661893b57A865F78ac62710F9B3, 2830, 263, 242, 21, 0, 263, 0, 0, 1.0, 43195, ss: 128 sss: 32 
0x16931cce37f3d379667d2c547d4a51500c004aa5, 1509, 107, 106, 1, 0, 107, 0, 0, 1.0, 31633, ss: 128 sss: 32 
0x39e07862f4f9598721032cbf34557d5b119c09e9, 1521, 107, 106, 1, 0, 107, 0, 0, 1.0, 46376, ss: 128 sss: 32 
0xe29a8d906d01d667c5f735e1680f9c79685a7946, 685, 40, 40, 0, 0, 40, 0, 0, 1.0, 457, ss: 128 sss: 32 
0x44d6035e226907a76187910e256193b2f50f5009, 2563, 230, 211, 19, 0, 230, 0, 0, 1.0, 63275, ss: 128 sss: 32 
0x9019a2ce9e034f7794643262490ef7b336e6a2b2, 2135, 195, 183, 12, 0, 195, 0, 0, 1.0, 43167, ss: 128 sss: 32 
0x334f34c0c9db9450a3b043c8578285c0b0897a32, 2687, 93, 93, 0, 0, 93, 0, 0, 1.0, 9384, ss: 128 sss: 32 
0x7c6ECf809bc86518458fcC87CdC73B9a4289Cc40, 2954, 275, 262, 13, 0, 275, 0, 0, 1.0, 135815, ss: 128 sss: 32 
0xC51e219951E9a76751E812A59e003A548803B9D8, 2231, 155, 154, 1, 0, 155, 0, 0, 1.0, 61380, ss: 128 sss: 32 
0xb416546b9dd75dc1704ecf7cc1117800ba3193e4, 1224, 88, 87, 1, 0, 88, 0, 0, 1.0, 12670, ss: 128 sss: 32 
0x6dbd0d2098607ed3d284d2c0b8a4637c0ebcfaf0, 1511, 107, 106, 1, 0, 107, 0, 0, 1.0, 33866, ss: 128 sss: 32 
0xcaa7f414906138a05051ecb759163dcc20514510, 2300, 159, 155, 4, 0, 159, 0, 0, 1.0, 123312, ss: 128 sss: 32 
0x47b7310b6859a2c60d783f71c28709be7c914cac, 1900, 171, 159, 12, 0, 171, 0, 0, 1.0, 55915, ss: 128 sss: 32 
0x0ab1a7c0ed0c8987fa2b9317d2fe0f39fa2b36c1, 1793, 177, 172, 5, 0, 177, 0, 0, 1.0, 15115, ss: 128 sss: 32 
0x199bb61dcb3e1a8e05fbf847a8e8c724dc7272c3, 1524, 107, 106, 1, 0, 107, 0, 0, 1.0, 61940, ss: 128 sss: 32 
0x1ac4bccc0c193b0baa44cdc7a18d298492762fc8, 1523, 108, 106, 2, 0, 108, 0, 0, 1.0, 55952, ss: 128 sss: 32 
0x69e284ad900642dd1998cf77e037182bb0d374d1, 1504, 107, 106, 1, 0, 107, 0, 0, 1.0, 47977, ss: 128 sss: 32 
0x1a1d4bc130d7c98c35019e0a05187d049ef0bf4b, 2927, 263, 248, 15, 0, 263, 0, 0, 1.0, 79841, ss: 128 sss: 32 
0xfc2bf4e3d77d8f95e3c0e5837b01d4720a04a6a0, 397, 23, 22, 1, 0, 23, 0, 0, 1.0, 201, ss: 128 sss: 32 
0xb052e1f0a856b062285bafeb5e192b7b67e047de, 1591, 108, 108, 0, 0, 108, 0, 0, 1.0, 63700, ss: 128 sss: 32 
0x3AD453aB9aEd17EBa23C4c4f8CeB18025CA6495a, 1996, 144, 143, 1, 0, 144, 0, 0, 1.0, 40537, ss: 128 sss: 32 
0x8746b1e5B3cf2E094947B8d37dA670d9B0BF6774, 2859, 247, 234, 13, 0, 247, 0, 0, 1.0, 112151, ss: 128 sss: 32 
0x75272b96b7685834ef49b406e6a333ea28b10860, 1025, 85, 81, 4, 0, 85, 0, 0, 1.0, 38009, ss: 128 sss: 32 
0x1bd1fbef17feb444914c5bf5ff10d2b8c8bd0935, 1515, 107, 106, 1, 0, 107, 0, 0, 1.0, 31888, ss: 128 sss: 32 
0x3932f366886d2b981485503a182173da80d15c97, 1202, 90, 89, 1, 0, 90, 0, 0, 1.0, 29853, ss: 128 sss: 32 
0x7B55617f7F04F7B45eE865fF9066469Fbe28a632, 2576, 256, 248, 8, 0, 256, 0, 0, 1.0, 224079, ss: 128 sss: 32 
0xf7783e451fcbf7ccc2e15b7fee4f534b41ecd6e4, 1511, 107, 106, 1, 0, 107, 0, 0, 1.0, 74214, ss: 128 sss: 32 
0x1ECD061fF63aB5D0355cB96bBf88cF7E5c9c53D7, 2963, 275, 262, 13, 0, 275, 0, 0, 1.0, 64293, ss: 128 sss: 32 
0x7ae5597218a4f55bc660e9f95514b5edecd90daf, 1887, 124, 124, 0, 0, 124, 0, 0, 1.0, 24778, ss: 128 sss: 32 
0x777cefd7b51515f896f627d993f7c5cc0c4a14f3, 1510, 107, 106, 1, 0, 107, 0, 0, 1.0, 51603, ss: 128 sss: 32 
0x35BC60B5B7bcfA4fc2B123A4c1A8B3C8c9a801ED, 2967, 275, 262, 13, 0, 275, 0, 0, 1.0, 94231, ss: 128 sss: 32 
0x2Ba661b64dbe494564c88849d83Bd586eb1D8D20, 1594, 113, 111, 2, 0, 113, 0, 0, 1.0, 23152, ss: 128 sss: 32 
0xfa15c2d3ab938fcc90f1f1009b1bda2b3f48c1d4, 1217, 87, 87, 0, 0, 87, 0, 0, 1.0, 10423, ss: 128 sss: 32 
0xb30aef19a72d235090100795dacfaf529813f1f3, 1390, 110, 110, 0, 0, 110, 0, 0, 1.0, 24422, ss: 128 sss: 32 
0x3476662037c81757d23fa2cd78add513c7fa4c04, 1509, 107, 106, 1, 0, 107, 0, 0, 1.0, 45625, ss: 128 sss: 32 
0xd936aE8647742873Cb045cd7cA25427789fABA13, 1297, 100, 99, 1, 0, 100, 0, 0, 1.0, 29274, ss: 128 sss: 32 
0x164489fda2ad90f691017b457aece92caa3b0fdb, 2772, 195, 189, 6, 0, 195, 0, 0, 1.0, 74076, ss: 128 sss: 32 
0x5999a3056eeade9440da872678dc90a49c2f2b5d, 2833, 245, 227, 18, 0, 245, 0, 0, 1.0, 75085, ss: 128 sss: 32 
0x2aebd5367a70bb7e1157a7a54fff9c2a79d2aa39, 1504, 107, 106, 1, 0, 107, 0, 0, 1.0, 64905, ss: 128 sss: 32 
0xdf0d32b07025d335ddbe7cf713652577a657ddb5, 2894, 278, 270, 8, 0, 278, 0, 0, 1.0, 131203, ss: 128 sss: 32 
0x1aae838689be723c36efe59bee351d60b4f3f9ae, 1823, 89, 89, 0, 0, 89, 0, 0, 1.0, 5574, ss: 128 sss: 32 
0xa25150b69733D6834628613E712934C279BEadF7, 1908, 171, 159, 12, 0, 171, 0, 0, 1.0, 45432, ss: 128 sss: 32 
0xd2fc2000e9bba1e700b7984db01ec8a881308ad5, 544, 62, 62, 0, 0, 62, 0, 0, 1.0, 2584, ss: 128 sss: 32 
0xE80CA594A2df9226Ad8cf582375eF00aa98B2884, 1900, 157, 151, 6, 0, 157, 0, 0, 1.0, 66937, ss: 128 sss: 32 
0xd0f9bb81a50d35addb02e66727ff6a0733bf7def, 1623, 115, 114, 1, 0, 115, 0, 0, 1.0, 62671, ss: 128 sss: 32 
0xdffee7e073b6873263f2515a7501aa88ea49e5f5, 1663, 120, 119, 1, 0, 120, 0, 0, 1.0, 28953, ss: 128 sss: 32 
0x00980fc0ae2522ce8de8bae9ee06bda4a740f450, 1918, 171, 159, 12, 0, 171, 0, 0, 1.0, 66742, ss: 128 sss: 32 
0x5443c7b68cdc45a2c69587eca7f84eb36ccc90d8, 1627, 115, 114, 1, 0, 115, 0, 0, 1.0, 43768, ss: 128 sss: 32 
0x86cea05cf85ef67559f0da36da43ac481e0df92f, 1519, 107, 106, 1, 0, 107, 0, 0, 1.0, 65139, ss: 128 sss: 32 
0x422593dd0c4707b5911a71da56a6d5772fbae857, 1646, 159, 152, 7, 0, 159, 0, 0, 1.0, 41616, ss: 128 sss: 32 
0xeac7de44477c46f5bba4147ad5a3a10fee93688c, 1219, 87, 87, 0, 0, 87, 0, 0, 1.0, 16927, ss: 128 sss: 32 
0xcb8c0ac0c303a36ff884bf0a938e7540c9fa38cc, 1507, 107, 106, 1, 0, 107, 0, 0, 1.0, 44052, ss: 128 sss: 32 
0x6672e4027d7a42187c7e69b8ccf5927ead0e5b7b, 2593, 247, 231, 16, 0, 247, 0, 0, 1.0, 46387, ss: 128 sss: 32 
0xc044A45eb577A6F9Da46dcfb34EE3A68c1585837, 1324, 87, 87, 0, 0, 87, 0, 0, 1.0, 38179, ss: 128 sss: 32 
0x517964d868560f6a0c5f9258c7fdf14d136abb96, 1496, 103, 103, 0, 0, 103, 0, 0, 1.0, 50110, ss: 128 sss: 32 
0xdc71f36a5025c734b31dd49283e6f7d91d312edc, 1554, 108, 107, 1, 0, 108, 0, 0, 1.0, 45968, ss: 128 sss: 32 
0xd6e8e37bb53919f7beb280bef8a621d530f62681, 1590, 109, 108, 1, 0, 109, 0, 0, 1.0, 41291, ss: 128 sss: 32 
0xE2A9b2C04b06ba4F78b451e1727457a3e072F105, 1606, 159, 157, 2, 0, 159, 0, 0, 1.0, 259778, ss: 128 sss: 32 
0xEa864d968822A022c98c410fB6bc590CefE80109, 2879, 252, 235, 17, 0, 252, 0, 0, 1.0, 91505, ss: 128 sss: 32 
0xbb86856e9ba03351c68953a6861ff30bdc1b9d9d, 1819, 90, 89, 1, 0, 90, 0, 0, 1.0, 4646, ss: 128 sss: 32 
0x5388df74d5805d40645ef4de466aff0efe295734, 1529, 107, 106, 1, 0, 107, 0, 0, 1.0, 55899, ss: 128 sss: 32 
0x9d364dd1f132456c0e9bc201f4b75e7087544098, 2453, 219, 205, 14, 0, 219, 0, 0, 1.0, 35306, ss: 128 sss: 32 
0xe2292439b8f6521ef41066a92a604e5e6462b4d2, 1349, 94, 92, 2, 0, 94, 0, 0, 1.0, 25049, ss: 128 sss: 32 
0xc3b31db4f2d65f51f34bd0fcf2040f568d050b58, 1834, 130, 127, 3, 0, 130, 0, 0, 1.0, 27472, ss: 128 sss: 32 
0xa0ed6b9b72e9f289a756852a152eb22e3d4ff4e3, 1610, 115, 114, 1, 0, 115, 0, 0, 1.0, 62374, ss: 128 sss: 32 
0x6412816b834caa82d8be0c601ea4aa60ed97a871, 2799, 195, 187, 8, 0, 195, 0, 0, 1.0, 57009, ss: 128 sss: 32 
0x3d4df25fbd25d98e01380bcd69f60a36f970d69a, 2414, 226, 215, 11, 0, 226, 0, 0, 1.0, 83674, ss: 128 sss: 32 
0x3783d82205a93125803518dd84d6a225d48a4800, 1525, 115, 113, 2, 0, 115, 0, 0, 1.0, 39813, ss: 128 sss: 32 
0x63863446de48223915e904616def4e81009654c6, 2881, 252, 236, 16, 0, 252, 0, 0, 1.0, 101979, ss: 128 sss: 32 
0xc0ed4685f365883efce05135e78f9e9e71fe194f, 1602, 110, 109, 1, 0, 110, 0, 0, 1.0, 34771, ss: 128 sss: 32 
0xc11d039f84469d964495ab8fb3cbb56bc6dcd192, 1519, 107, 106, 1, 0, 107, 0, 0, 1.0, 43936, ss: 128 sss: 32 
0x9c3698572f4214b97d4a4d5a3dc1a6f6d49a903b, 1522, 107, 106, 1, 0, 107, 0, 0, 1.0, 61326, ss: 128 sss: 32 
0xb0b5c6b0e791ccc6900810a3c3acd07705d534d0, 2867, 248, 223, 25, 0, 248, 0, 0, 1.0, 54970, ss: 128 sss: 32 
0x47a55198cd3f1b6dfa39e911f1dc20ecf9da9507, 1505, 103, 103, 0, 0, 103, 0, 0, 1.0, 50909, ss: 128 sss: 32 
0xd45f8eab03fd454b8a2b7fd9a2ad372825ea59a6, 2033, 151, 150, 1, 0, 151, 0, 0, 1.0, 79924, ss: 128 sss: 32 
0xd074f1bb1d9c3db645bdd2203df30962bb5abffb, 2955, 275, 262, 13, 0, 275, 0, 0, 1.0, 117075, ss: 128 sss: 32 
0xccc2b6564f4c341c0714c290217bce4401dcd917, 2879, 277, 264, 13, 0, 277, 0, 0, 1.0, 163433, ss: 128 sss: 32 
0x76159e8c48565cafba15fe4aa5c09671293725f3, 1511, 107, 106, 1, 0, 107, 0, 0, 1.0, 34680, ss: 128 sss: 32 
0xb7e0bba8aa5807167036151db807d9624fae2078, 818, 73, 73, 0, 0, 73, 0, 0, 1.0, 12891, ss: 128 sss: 32 
0xd0Ec91D5389b63E4d1faa59269366233b4050235, 980, 71, 69, 2, 0, 71, 0, 0, 1.0, 194814, ss: 128 sss: 32 
0xb466E4c777d4A37c8fe0a2D47eF0D1FF5ca842A3, 1311, 87, 87, 0, 0, 87, 0, 0, 1.0, 40829, ss: 128 sss: 32 
0x271a8a5d898d802ba53fa31b592f5a93f56f33b5, 1528, 108, 106, 2, 0, 108, 0, 0, 1.0, 51952, ss: 128 sss: 32 
0x90e7ec3f2a049a4cc71b7c86741f4ab37c7f98a4, 2586, 182, 175, 7, 0, 182, 0, 0, 1.0, 69804, ss: 128 sss: 32 
0xae27e10ac49f40f8dd63eef491108af91844245f, 1504, 107, 106, 1, 0, 107, 0, 0, 1.0, 69489, ss: 128 sss: 32 
0x333778c33ba91b9afb166636387bb21c88b094ba, 2265, 151, 147, 4, 0, 151, 0, 0, 1.0, 92289, ss: 128 sss: 32 
0x2bf3559a70ed1690de386c434d6b567800b3e226, 1514, 107, 106, 1, 0, 107, 0, 0, 1.0, 47882, ss: 128 sss: 32 
0x89D8DBd75Df9ed93B43944cDDbB162134A7bBA4b, 2964, 275, 262, 13, 0, 275, 0, 0, 1.0, 92984, ss: 128 sss: 32 
0xa7E40771AedB7CCfe9dB9304D55F5a508DBa7C39, 2950, 275, 262, 13, 0, 275, 0, 0, 1.0, 93408, ss: 128 sss: 32 
0x018fa7ae6913a740843a477b20a81dc4286e5b60, 1596, 109, 108, 1, 0, 109, 0, 0, 1.0, 60460, ss: 128 sss: 32 
0x4c13d39147a38765043cd6b7cb0281d419bfecd8, 2585, 191, 189, 2, 0, 191, 0, 0, 1.0, 39713, ss: 128 sss: 32 
0x647cf62b24cfafdf57f52cb55081aca156958f98, 1489, 103, 103, 0, 0, 103, 0, 0, 1.0, 63810, ss: 128 sss: 32 
0x798838e8099486eed8e66e5fedf6c1e72a3b3820, 1528, 108, 106, 2, 0, 108, 0, 0, 1.0, 63930, ss: 128 sss: 32 
0x4cecd3bbc9a79d5d0bb651c86caaefc34b104445, 1519, 107, 106, 1, 0, 107, 0, 0, 1.0, 66379, ss: 128 sss: 32 
0xab3b517f6a9aa09153ffb1395ac7cc1dd742506d, 1504, 107, 106, 1, 0, 107, 0, 0, 1.0, 46236, ss: 128 sss: 32 
