Smart Contract, Total Opcodes, Total Jumps, Solved Jumps, Definitely unreachable jumps, Maybe unreachable jumps, Total solved Jumps, Unsound jumps, Maybe unsound jumps, % Total Solved, Time (millis), Notes 
0xe7ffa77b74cfb68b7aa45ac94f9b1baacbce850c, 1236, 87, 87, 0, 0, 87, 0, 0, 1.0, 19154, ss: 64 sss: 32 
0xf50e161958c16f450cfc62549cb8ca44c3fb4291, 1588, 108, 108, 0, 0, 108, 0, 0, 1.0, 49165, ss: 64 sss: 32 
0x3e2b03a8990b229d33bbaa148821293eb6e10738, 245, 29, 26, 3, 0, 29, 0, 0, 1.0, 1801, ss: 64 sss: 32 
0x3db3b827b303e401b98ec2e5e9eecad064d72cab, 423, 25, 23, 2, 0, 25, 0, 0, 1.0, 1802, ss: 64 sss: 32 
0x6617f50bd993f86045cfdf99e579bf9d7225125f, 1488, 103, 103, 0, 0, 103, 0, 0, 1.0, 60161, ss: 64 sss: 32 
0x16da19dbbff11467abc3f4a2e705d7cb77643526, 1772, 137, 125, 12, 0, 137, 0, 1, 1.0, 4527, ss: 64 sss: 32 
0x66619dfca339c43b22e8aa429e5c477e6fd65ab1, 2793, 223, 219, 4, 0, 223, 0, 0, 1.0, 34516, ss: 64 sss: 32 
0x3fac10e640b8d3e9c2839f66b2ee3f26372f8b78, 1806, 140, 134, 6, 0, 140, 0, 0, 1.0, 16659, ss: 64 sss: 32 
0xd3fd7978e7786179f5b0386d60119097701ff42d, 1040, 108, 107, 1, 0, 108, 0, 0, 1.0, 15028, ss: 64 sss: 32 
0xF1dDE04c3fb8f21523C9aF006e1094A476AC366A, 2296, 174, 162, 12, 0, 174, 0, 0, 1.0, 25919, ss: 64 sss: 32 
0x0ed0881280ca6141974c9604b75d994c6fd92ef8, 1273, 98, 98, 0, 0, 98, 0, 0, 1.0, 24296, ss: 64 sss: 32 
0x86b939Ff9bb3cC5Cd9c7B57D298D6D20B4c7Bb56, 1427, 87, 87, 0, 0, 87, 0, 0, 1.0, 1293, ss: 64 sss: 32 
0x3280037f01757b73d0612cb4792d840f01fdac09, 2465, 171, 163, 8, 0, 171, 0, 0, 1.0, 33385, ss: 64 sss: 32 
0x2c2739034a3F8f229029aFEC0FA62345753e69BB, 1711, 135, 135, 0, 0, 135, 0, 0, 1.0, 30054, ss: 64 sss: 32 
0x836beed5235b794fa38e86a9ad1680035f607b12, 2802, 252, 237, 15, 0, 252, 0, 0, 1.0, 20897, ss: 64 sss: 32 
0xbE360D6D56F3504a7C2971a03BA34a3c6d67594F, 2190, 118, 114, 4, 0, 118, 0, 0, 1.0, 7267, ss: 64 sss: 32 
0xaee45d771e173506456e20fbdec12de9afdd593f, 1609, 110, 109, 1, 0, 110, 0, 0, 1.0, 30974, ss: 64 sss: 32 
0xc596947037572f1b514931a1fcec6909c6e909ff, 2036, 164, 158, 6, 0, 164, 0, 0, 1.0, 17630, ss: 64 sss: 32 
0x3053dc675b09530b815072e7940ecb5fd19bc8a6, 1396, 110, 110, 0, 0, 110, 0, 0, 1.0, 11825, ss: 64 sss: 32 
0x03ecf73968d146a24e51c2ac5f79389ad5801e64, 1506, 110, 110, 0, 0, 110, 0, 0, 1.0, 33948, ss: 64 sss: 32 
0x1e4d2b778138eb89def080071c427ba0f203b0ac, 1014, 84, 81, 3, 0, 84, 0, 0, 1.0, 20117, ss: 64 sss: 32 
0x4417265c6a4f2b041e5ccd2c9dfb30c819ea4df4, 1603, 109, 109, 0, 0, 109, 0, 0, 1.0, 26088, ss: 64 sss: 32 
0xd74bd64629e4d8bf72cc3ea26fa42a7b1bcbaddf, 1584, 107, 106, 1, 0, 107, 0, 0, 1.0, 14128, ss: 64 sss: 32 
0x9456e90877d59ac294d60217bd38d271cbfc0356, 1587, 110, 110, 0, 0, 110, 0, 0, 1.0, 18736, ss: 64 sss: 32 
0xA651332Bf73905c326bdA4549A59c05Aa3bF7DA0, 980, 71, 69, 2, 0, 71, 0, 0, 1.0, 93752, ss: 64 sss: 32 
0xe8073e400e17186efd2911afa2310071c81f3d77, 2478, 170, 163, 7, 0, 170, 0, 0, 1.0, 34125, ss: 64 sss: 32 
0x6fe62ff9140055fc8a8b5adfa302dbfdb4876858, 1605, 110, 109, 1, 0, 110, 0, 0, 1.0, 18286, ss: 64 sss: 32 
0x4074e0c6bd91d27fe48dbec3719a5cd7930505a9, 1605, 110, 109, 1, 0, 110, 0, 0, 1.0, 30568, ss: 64 sss: 32 
0x1a0205cd3fa5b3d8a11444a14b6c0fc993c2dc14, 1578, 108, 108, 0, 0, 108, 0, 0, 1.0, 40427, ss: 64 sss: 32 
0x90e25a72500afd34b5c88e8b4a9976ad8be92d14, 1584, 108, 108, 0, 0, 108, 0, 0, 1.0, 21905, ss: 64 sss: 32 
0x96f297c5c2fb481889c0b0f5f4adec61911236c4, 2037, 151, 150, 1, 0, 151, 0, 0, 1.0, 30487, ss: 64 sss: 32 
0x901184c47defff50663ea102f9790315a5317adb, 1896, 147, 147, 0, 0, 147, 0, 0, 1.0, 14920, ss: 64 sss: 32 
0x0002fa5b2e2dcc7ed5f4b26d5cea14e44d187e03, 1815, 94, 89, 5, 0, 94, 0, 0, 1.0, 6110, ss: 64 sss: 32 
0x60f19fd1f15fc08a1ea27d407dae25c4e7937547, 641, 53, 53, 0, 0, 53, 0, 0, 1.0, 550, ss: 64 sss: 32 
0x25E54Bf48369b8FB25bB79d3a3Ff7F3BA448E382, 2361, 125, 118, 7, 0, 125, 0, 0, 1.0, 4083, ss: 64 sss: 32 
0x15d9d21936fa6b0a494556db58eb93e2edd267f0, 1220, 87, 87, 0, 0, 87, 0, 0, 1.0, 6193, ss: 64 sss: 32 
0x3c862c59fa230df83b87f1ae742f2a6559f59fb0, 1587, 108, 108, 0, 0, 108, 0, 0, 1.0, 21409, ss: 64 sss: 32 
0xaa89568540a083776292ae5d1f838cf28c798f5e, 1486, 103, 103, 0, 0, 103, 0, 0, 1.0, 48521, ss: 64 sss: 32 
0xa8ed3d016b308ab48ecee135222b9105e7661e92, 1613, 110, 109, 1, 0, 110, 0, 0, 1.0, 17491, ss: 64 sss: 32 
0xa6c9976893eacb13688c16689ea183ce29004855, 1261, 92, 92, 0, 0, 92, 0, 0, 1.0, 74247, ss: 64 sss: 32 
0x16eA5Db6A7C2A72749a7f7600CAA64c97468D50E, 783, 51, 48, 3, 0, 51, 0, 0, 1.0, 1940, ss: 64 sss: 32 
0x5de11cbc26705AA30853526F809EC18dBe55aD5b, 1237, 92, 92, 0, 0, 92, 0, 0, 1.0, 17050, ss: 64 sss: 32 
0x3446d9a92b0d1d8db12507e850c158828fae4d95, 720, 61, 61, 0, 0, 61, 0, 0, 1.0, 1393, ss: 64 sss: 32 
0x98ce663e6ccbe12fdc2397b2a8d1ed0352476f78, 608, 48, 48, 0, 0, 48, 0, 0, 1.0, 675, ss: 64 sss: 32 
0x5ead618e4b55e34310908b647063b70416eac761, 998, 62, 62, 0, 0, 62, 0, 0, 1.0, 9628, ss: 64 sss: 32 
0x1855445a92453eDbdaE8072d123645698Ac9D2fF, 1901, 150, 146, 4, 0, 150, 0, 0, 1.0, 11725, ss: 64 sss: 32 
0x5371416b6cbee8710e2832728b31ce743856b30b, 1584, 107, 106, 1, 0, 107, 0, 0, 1.0, 30264, ss: 64 sss: 32 
0xd523578e864b1e7741309e21cb29674a4f634807, 1221, 109, 109, 0, 0, 109, 0, 0, 1.0, 30696, ss: 64 sss: 32 
0x0000000000008dd2574908774527FD6DA397d75B, 525, 39, 38, 1, 0, 39, 0, 0, 1.0, 199, ss: 64 sss: 32 
0x3ea06c27b0e18f4cb977eea6ad0b0b3a1d3e8577, 1390, 110, 110, 0, 0, 110, 0, 0, 1.0, 19485, ss: 64 sss: 32 
0xea15fe16d39316130ad93ac0515f2432e8be3648, 1517, 127, 127, 0, 0, 127, 0, 0, 1.0, 19162, ss: 64 sss: 32 
0xced519a9e7555dee0399f8da3019d8d557a88f81, 1564, 103, 103, 0, 0, 103, 0, 0, 1.0, 29492, ss: 64 sss: 32 
0x8F18602AF63138fB598772410BFB2514746f61E0, 1641, 139, 138, 1, 0, 139, 0, 0, 1.0, 9459, ss: 64 sss: 32 
0x5eC34376205E99f5314cD71436AFDA100f3A4Bb6, 1072, 43, 43, 0, 0, 43, 0, 0, 1.0, 1126, ss: 64 sss: 32 
0x7576917e8ecaff11d64bcb30cd407f2f1cef2b64, 2836, 197, 189, 8, 0, 197, 0, 0, 1.0, 20197, ss: 64 sss: 32 
0x679a55c36155a6cbf86eac22e75e33fb704e2d6e, 544, 40, 40, 0, 0, 40, 0, 0, 1.0, 311, ss: 64 sss: 32 
0x81ef2af332cf422cf51aea1e1a284c01e7f10336, 1505, 110, 110, 0, 0, 110, 0, 0, 1.0, 37414, ss: 64 sss: 32 
0x3c9F53a0aef44A20A18f341E45a698Ba36f102A4, 2323, 187, 187, 0, 0, 187, 0, 0, 1.0, 26655, ss: 64 sss: 32 
0xd15314257404ae4b32b70f39a883db52e57e40c8, 1907, 147, 147, 0, 0, 147, 0, 0, 1.0, 32963, ss: 64 sss: 32 
0x9531695Be421C2A3B11D4eC926edF813498021fE, 2863, 220, 204, 16, 0, 220, 0, 0, 1.0, 36330, ss: 64 sss: 32 
0xD99E8bA5259Dd2b8B9aBFE0eD78913ec60B8F898, 1080, 83, 81, 2, 0, 83, 0, 0, 1.0, 4202, ss: 64 sss: 32 
0xa801a49a37a09b2022b5d1f2222421a2f2d5656d, 1514, 110, 110, 0, 0, 110, 0, 0, 1.0, 18395, ss: 64 sss: 32 
0x6ca8937103a6a73025a9be86d4af90dabc019f0f, 1559, 103, 103, 0, 0, 103, 0, 0, 1.0, 16689, ss: 64 sss: 32 
0x641d512a5a3be7f07ede4bb66fcc3546b5c24622, 1005, 84, 81, 3, 0, 84, 0, 0, 1.0, 15803, ss: 64 sss: 32 
0x5d207dbd80b978b138331519383b27caa1e04999, 253, 18, 18, 0, 0, 18, 0, 0, 1.0, 41, ss: 64 sss: 32 
0xE67404C6E4f6Ab58ac1F92E6056379CD2F4AAc6A, 2049, 146, 145, 1, 0, 146, 0, 0, 1.0, 36300, ss: 64 sss: 32 
0xa944c2e3b8356a26cd788ed4e2655720261e02cb, 153, 9, 9, 0, 0, 9, 0, 0, 1.0, 1939, ss: 64 sss: 32 
0xC27EEc1c192500DaA517D491f673eD81008a8c0b, 2174, 170, 155, 15, 0, 170, 0, 1, 1.0, 12882, ss: 64 sss: 32 
0x63b0a86677df915812fdd3acff5ae7382f731d34, 2699, 193, 192, 1, 0, 193, 0, 0, 1.0, 29825, ss: 64 sss: 32 
0x0355950f91e36b1dcf42360b06486b4e0021351a, 1593, 108, 108, 0, 0, 108, 0, 0, 1.0, 37883, ss: 64 sss: 32 
0x726c8bf7c2bc8d6f76e484dbfc4dceddf3c35fae, 1586, 108, 108, 0, 0, 108, 0, 0, 1.0, 32715, ss: 64 sss: 32 
0xe743a92cf9ec592593055a6d4bf940c645db2e61, 1215, 92, 92, 0, 0, 92, 0, 0, 1.0, 21322, ss: 64 sss: 32 
0xb04862d030a38c351e8ecae09508cd30f80d88e3, 1820, 95, 89, 6, 0, 95, 0, 0, 1.0, 5808, ss: 64 sss: 32 
0x025382d4266cca4689055bb08b73202ce24e9b12, 1905, 147, 147, 0, 0, 147, 0, 0, 1.0, 31041, ss: 64 sss: 32 
0x5d551ffff320a7d52eca30df0af449bb5df8efc5, 2029, 150, 149, 1, 0, 150, 0, 0, 1.0, 21996, ss: 64 sss: 32 
0x910ac8d84d2badcceeb859dbb624b69d430758cd, 1606, 108, 108, 0, 0, 108, 0, 0, 1.0, 38700, ss: 64 sss: 32 
0x6705c9f03763d0b509c5d4aa5144963cb7641dd9, 901, 96, 95, 1, 0, 96, 0, 0, 1.0, 4369, ss: 64 sss: 32 
0xECc4457b322271f8615cA583789790e1a7b2e1af, 2522, 115, 110, 5, 0, 115, 0, 0, 1.0, 25426, ss: 64 sss: 32 
0x0956b6c651bb211b2bccdaa14ca9f1db3ae879e9, 1011, 84, 81, 3, 0, 84, 0, 0, 1.0, 14166, ss: 64 sss: 32 
0x1991a5BfCC94269E7ADc1363B606535d52e34B50, 2155, 164, 147, 17, 0, 164, 0, 1, 1.0, 10085, ss: 64 sss: 32 
0xe5cE54704f1B23de22b687eee628B32600ADC681, 2103, 124, 122, 2, 0, 124, 0, 0, 1.0, 28685, ss: 64 sss: 32 
0x1d4AAEaE7C8b75a8e5ab589a84516853DBDdd735, 2054, 139, 136, 3, 0, 139, 0, 0, 1.0, 6897, ss: 64 sss: 32 
0x1041D127b2d4BC700F0F563883bC689502606918, 1911, 149, 146, 3, 0, 149, 0, 0, 1.0, 29707, ss: 64 sss: 32 
0x01862Ecae91956396dF56479694A4D79920C0246, 148, 9, 9, 0, 0, 9, 0, 0, 1.0, 82, ss: 64 sss: 32 
0xe015fc859b3f6a42a383930862c390fb4bdffdab, 1581, 108, 108, 0, 0, 108, 0, 0, 1.0, 34177, ss: 64 sss: 32 
0xe9262aa028e6dfeb1dca3bb1c07faf0707544b86, 719, 54, 54, 0, 0, 54, 0, 0, 1.0, 229, ss: 64 sss: 32 
0x55a15dc18bb67b8687874d39cf69cbdac80ef645, 2808, 195, 187, 8, 0, 195, 0, 0, 1.0, 21283, ss: 64 sss: 32 
0xcbce33a40e6b52e28c53abf7d12d4cba961312f7, 1384, 110, 110, 0, 0, 110, 0, 0, 1.0, 31314, ss: 64 sss: 32 
0x9960012D71d2085516646B411925AD1d115ED01F, 170, 8, 6, 2, 0, 8, 0, 0, 1.0, 48, ss: 64 sss: 32 
0x7Afa3d0E44046C7ce8094dC429305A7ff3706D10, 184, 8, 6, 2, 0, 8, 0, 0, 1.0, 37, ss: 64 sss: 32 
0xd5bcB7d3861050f19563bf8C7aD243c07Cf840FE, 1477, 104, 99, 5, 0, 104, 0, 0, 1.0, 2111, ss: 64 sss: 32 
0xAb2D7080faa744759519BF20D8200a851d9B1E53, 2188, 143, 139, 4, 0, 143, 0, 0, 1.0, 30379, ss: 64 sss: 32 
0x12721046Ad01eB97C2d58Cb518d512b4073F6813, 1331, 87, 87, 0, 0, 87, 0, 0, 1.0, 18245, ss: 64 sss: 32 
0x55bbe5a04d144d8d17dc6471f23e1a40b63333d4, 465, 19, 19, 0, 0, 19, 0, 0, 1.0, 135, ss: 64 sss: 32 
0x4a053b7c4cbbe72300f1986e39881bd21d646536, 2527, 188, 183, 5, 0, 188, 0, 0, 1.0, 15247, ss: 64 sss: 32 
0x7603352f1C4752Ac07AAC94e48632b65FDF1D35c, 2282, 155, 148, 7, 0, 155, 0, 0, 1.0, 3748, ss: 64 sss: 32 
0xee13e63529c39f95926577f9acb2a6fdd912b141, 1467, 112, 111, 1, 0, 112, 0, 0, 1.0, 16901, ss: 64 sss: 32 
0xa72d663133699d8c1e2987bdb7265e8deb7756ac, 1217, 87, 87, 0, 0, 87, 0, 0, 1.0, 10112, ss: 64 sss: 32 
0x3B1554f346DFe5c482Bb4BA31b880c1C18412170, 177, 16, 16, 0, 0, 16, 0, 0, 1.0, 137, ss: 64 sss: 32 
0x5b73c0c7c3c93e1b0d69296ef156ddd63e368a2b, 1113, 79, 78, 1, 0, 79, 0, 0, 1.0, 16914, ss: 64 sss: 32 
0x51221550f9ce9435ef252f7f863403600804ae9c, 1962, 147, 141, 6, 0, 147, 0, 0, 1.0, 9104, ss: 64 sss: 32 
0x6479c975aee835dceac11570984b879ae6ccb7d2, 2306, 206, 194, 12, 0, 206, 0, 0, 1.0, 15125, ss: 64 sss: 32 
0x3b9e222f2a8fb9fc36083516aa41ba6010c9690e, 1582, 108, 108, 0, 0, 108, 0, 0, 1.0, 61318, ss: 64 sss: 32 
0x37d037f8fc5d822eb8921739438048e19b7e7151, 2114, 155, 154, 1, 0, 155, 0, 0, 1.0, 43052, ss: 64 sss: 32 
0xf7a9affda0aba42d9e625d8a119bf4f15d1921f7, 453, 38, 38, 0, 0, 38, 0, 0, 1.0, 208, ss: 64 sss: 32 
0xd6C1d391385F6a53bf02a7B4beD71441623D77e7, 2535, 115, 110, 5, 0, 115, 0, 0, 1.0, 19681, ss: 64 sss: 32 
0x769f6f368cc9949d29065da366fb86dbe9024367, 1594, 107, 106, 1, 0, 107, 0, 0, 1.0, 24356, ss: 64 sss: 32 
0x110429d46bb2e1e731f390e74e045f86e524ff24, 1706, 135, 135, 0, 0, 135, 0, 0, 1.0, 27361, ss: 64 sss: 32 
0x3c00fcf488712cd0430b6d4c77d6e48c3718a0ef, 1523, 127, 127, 0, 0, 127, 0, 0, 1.0, 19663, ss: 64 sss: 32 
0xE3deFaE93FabDC93da32aEc7FF71d5EC85e2e0bb, 2439, 177, 176, 1, 0, 177, 0, 0, 1.0, 25803, ss: 64 sss: 32 
0x72ad683f8608ddae0e1c80db6bba0913dc813bb3, 1483, 103, 103, 0, 0, 103, 0, 0, 1.0, 28858, ss: 64 sss: 32 
0x7a0b09c1974360d0370063ee7761d29803d45a74, 1009, 84, 81, 3, 0, 84, 0, 0, 1.0, 13088, ss: 64 sss: 32 
0x6D17e88Ade441073cc3ebFc2533CEf105Dab12aF, 2832, 262, 242, 20, 0, 262, 0, 0, 1.0, 44860, ss: 64 sss: 32 
0xf859256858091a7d78f0ae8dfe91cb30e5b1bc65, 600, 40, 37, 3, 0, 40, 0, 0, 1.0, 4155, ss: 64 sss: 32 
0x042074AAdD6d49e74d2e0164FfeFccD1FD66Cc39, 1316, 87, 87, 0, 0, 87, 0, 0, 1.0, 37729, ss: 64 sss: 32 
0x228ce526d70cd1d7853edfc39aa84e5e3438f4fc, 1478, 121, 121, 0, 0, 121, 0, 0, 1.0, 26325, ss: 64 sss: 32 
0xc3B006Cf383f33342910a8cd5706D4d76851a55C, 169, 8, 6, 2, 0, 8, 0, 0, 1.0, 15, ss: 64 sss: 32 
0xA416A7a07925d60F794E20532bc730749611A220, 2389, 189, 184, 5, 0, 189, 0, 0, 1.0, 8149, ss: 64 sss: 32 
0xaef558941a04e006b46c7f0c877547ccc1fda3a4, 1143, 69, 69, 0, 0, 69, 0, 0, 1.0, 2295, ss: 64 sss: 32 
0x42c5c42739078a21383c98431e8f8e553ecbdfe2, 1039, 68, 68, 0, 0, 68, 0, 0, 1.0, 6595, ss: 64 sss: 32 
0xcb5c447567631b187eea240512ba2fbbc875ce1d, 520, 34, 27, 7, 0, 34, 0, 0, 1.0, 99, ss: 64 sss: 32 
0xdeaed9594451001b32fccf2d6793f5491ec4d80b, 1607, 110, 109, 1, 0, 110, 0, 0, 1.0, 16256, ss: 64 sss: 32 
0x7e8f0ef6fec4a2cc78151b1103fcbb47c01807f2, 2026, 151, 150, 1, 0, 151, 0, 0, 1.0, 26654, ss: 64 sss: 32 
0xc6f9b3e1037d747166172b76d02fa38aadba94b9, 1510, 127, 127, 0, 0, 127, 0, 0, 1.0, 31095, ss: 64 sss: 32 
0x027e7c254a14a51d672db86a781646f46912027c, 1023, 84, 81, 3, 0, 84, 0, 0, 1.0, 12620, ss: 64 sss: 32 
0xdDB46Dbd9BC14a05F3d8660578561c4169D7B0fd, 1259, 98, 98, 0, 0, 98, 0, 0, 1.0, 10290, ss: 64 sss: 32 
0x398205434693c517f9992dec67c6809f617d8d9f, 2827, 262, 242, 20, 0, 262, 0, 0, 1.0, 45490, ss: 64 sss: 32 
0xfacd5fc10fbf80427aa2a5317f21096360c9ff8a, 1009, 84, 81, 3, 0, 84, 0, 0, 1.0, 10160, ss: 64 sss: 32 
0xc67ae4c367a70cc68fee468a1a3d23296fb9591d, 179, 6, 6, 0, 0, 6, 0, 0, 1.0, 1766, ss: 64 sss: 32 
0xeD3de6B0C6BCf88044E3B548c7de6F0ef99DaD07, 1325, 87, 87, 0, 0, 87, 0, 0, 1.0, 38621, ss: 64 sss: 32 
0x435197f681B01511C1bF6422c1Ba5272216e2B8A, 2972, 216, 206, 10, 0, 216, 0, 0, 1.0, 46991, ss: 64 sss: 32 
0x1b51AE89822E66Ad6f8CfC4a40cC4aea6641A181, 2525, 115, 110, 5, 0, 115, 0, 0, 1.0, 58610, ss: 64 sss: 32 
0xc3c3b5157b9fd6c18b0d842be745ff45ed33f79d, 1387, 110, 110, 0, 0, 110, 0, 0, 1.0, 26964, ss: 64 sss: 32 
0x3b6202199934022f307e99440df2405349a98f7e, 2048, 151, 150, 1, 0, 151, 0, 0, 1.0, 30329, ss: 64 sss: 32 
0x94D37F827740163cb7d939B56aF3B63cDe30B5c8, 2728, 147, 144, 3, 0, 147, 0, 0, 1.0, 345, ss: 64 sss: 32 
0xc7384444c5be31ee780085a669f408e5d51d6c2f, 1620, 110, 109, 1, 0, 110, 0, 0, 1.0, 36552, ss: 64 sss: 32 
0xfa74c2c7568ab156ade70e9d9c8610e71df3794d, 1358, 120, 120, 0, 0, 120, 0, 0, 1.0, 64030, ss: 64 sss: 32 
0x0594cb5ca47eFE1Ff25C7B8B43E221683B4Db34c, 730, 52, 48, 4, 0, 52, 0, 0, 1.0, 892, ss: 64 sss: 32 
0xc4300348912a26f304408261c1a322ce0920f2f8, 1481, 103, 103, 0, 0, 103, 0, 0, 1.0, 22612, ss: 64 sss: 32 
0xbe15e5ae5afb304c1e0cfe1d83bb2d519bc3ae87, 1476, 103, 103, 0, 0, 103, 0, 0, 1.0, 55703, ss: 64 sss: 32 
0xc32aca022fde174e15c70c7d1a5fc2e7e291d100, 1399, 110, 110, 0, 0, 110, 0, 0, 1.0, 23801, ss: 64 sss: 32 
0x7E2aae38d4eC59172018146057793DE445809b23, 2832, 262, 242, 20, 0, 262, 0, 0, 1.0, 46911, ss: 64 sss: 32 
0x203bbd2624524b4c20cf964ab04a3cb156adb03f, 1479, 103, 103, 0, 0, 103, 0, 0, 1.0, 23306, ss: 64 sss: 32 
0x2e27332b25ce245f6628377bc83573a001313c58, 1484, 112, 107, 5, 0, 112, 0, 0, 1.0, 3508, ss: 64 sss: 32 
0xc04057cbae8241584f098baed622564e428c7897, 1813, 89, 89, 0, 0, 89, 0, 0, 1.0, 1874, ss: 64 sss: 32 
0xf57fc9740a308bce89ff591f58672701ea8834dc, 1038, 107, 107, 0, 0, 107, 0, 0, 1.0, 22955, ss: 64 sss: 32 
0x023A0104c45bb4A3f09BeD1214F4e585e88541E5, 2521, 145, 145, 0, 0, 145, 0, 0, 1.0, 97908, ss: 64 sss: 32 
0x40fB1A1D8da89f1cb65828a5918aCc0D33217482, 2374, 153, 143, 10, 0, 153, 0, 0, 1.0, 2821, ss: 64 sss: 32 
0x7bc0a3cc5a75256c12df4c3a9fbb8ecbbcd57f9c, 2030, 151, 150, 1, 0, 151, 0, 0, 1.0, 65337, ss: 64 sss: 32 
0xce6aa7f6d78cfb9673c470b9fd7ed38a6d9fff35, 2033, 92, 92, 0, 0, 92, 0, 0, 1.0, 3554, ss: 64 sss: 32 
0x1cf5531a46986c8845bad948f5e6058b326f3cfe, 178, 6, 6, 0, 0, 6, 0, 0, 1.0, 21, ss: 64 sss: 32 
0x3155a180dab61e715faddc9335675da28e38afca, 2535, 115, 110, 5, 0, 115, 0, 0, 1.0, 48434, ss: 64 sss: 32 
0xa114e8e6d4a237e685e4a125270fcd0a828e831d, 1010, 84, 81, 3, 0, 84, 0, 0, 1.0, 18770, ss: 64 sss: 32 
0xf9694d828a03e6039cbf0959c9268f8ce5dad8d4, 1827, 148, 144, 4, 0, 148, 0, 0, 1.0, 19503, ss: 64 sss: 32 
0x9761b7c301b57ead03f51186158482d8adf73eba, 1228, 87, 87, 0, 0, 87, 0, 0, 1.0, 14811, ss: 64 sss: 32 
0x5903c054fdf73c98791a7d215d4f2e29a0908b68, 563, 23, 23, 0, 0, 23, 0, 0, 1.0, 242, ss: 64 sss: 32 
0x0aca8732dfa675efa103617cf5f95f3703674612, 2352, 173, 173, 0, 0, 173, 0, 0, 1.0, 56282, ss: 64 sss: 32 
0xc4772Be15F0483672CD5f16CA06456c46908B61c, 2106, 107, 106, 1, 0, 107, 0, 0, 1.0, 29436, ss: 64 sss: 32 
0x9dad403e285ac9148a0f88ad77c4115eaac3d8ca, 1390, 110, 110, 0, 0, 110, 0, 0, 1.0, 13043, ss: 64 sss: 32 
0x3252f6e66790f787df406384cd749a163d21313b, 1601, 110, 110, 0, 0, 110, 0, 0, 1.0, 35585, ss: 64 sss: 32 
0x1c3a52fb6b55ee670d92a41675e24408a305f6ae, 1578, 108, 108, 0, 0, 108, 0, 0, 1.0, 47968, ss: 64 sss: 32 
0xE520f941def9FeA4BE3e616E8489e2eA1fe23DaB, 980, 71, 69, 2, 0, 71, 0, 0, 1.0, 66045, ss: 64 sss: 32 
0x2780af41649c6a8cc4e6efbcd0940efed70da98b, 1486, 103, 103, 0, 0, 103, 0, 0, 1.0, 25884, ss: 64 sss: 32 
0x17988a539d58e963f34a26bfb3f687010e7a9d52, 1668, 63, 63, 0, 0, 63, 0, 0, 1.0, 3263, ss: 64 sss: 32 
0x539b1e6ce43d4400926a574241fedc61128a558c, 1024, 84, 81, 3, 0, 84, 0, 0, 1.0, 9964, ss: 64 sss: 32 
0x9397971f4179fa80fb039d038c6956774d65c979, 1031, 84, 81, 3, 0, 84, 0, 0, 1.0, 8358, ss: 64 sss: 32 
0xae21d99a0f223945a50d432c8fcd29f5834f00cb, 1826, 89, 89, 0, 0, 89, 0, 0, 1.0, 4032, ss: 64 sss: 32 
0x7e5d4877f12db6ee7b524dc24b34733427ce6991, 1164, 114, 101, 13, 0, 114, 0, 0, 1.0, 9112, ss: 64 sss: 32 
0x43882C864a406D55411b8C166bCA604709fDF624, 730, 52, 48, 4, 0, 52, 0, 0, 1.0, 361, ss: 64 sss: 32 
0x5d33438f55ef68ac12584d22cff27c5acab6846d, 1391, 110, 110, 0, 0, 110, 0, 0, 1.0, 23206, ss: 64 sss: 32 
0x83b79de37c2108ac586ab96aca8ad7c9143c55e9, 1016, 84, 81, 3, 0, 84, 0, 0, 1.0, 15943, ss: 64 sss: 32 
0x224b8cDd157fE44271b34918EE9f62e49e0d6b68, 1680, 135, 129, 6, 0, 135, 0, 0, 1.0, 13324, ss: 64 sss: 32 
0xccfcf6d39745b56dc3536c178c9acdb8dd9e9efd, 1585, 108, 108, 0, 0, 108, 0, 0, 1.0, 19931, ss: 64 sss: 32 
0xaad9508a5daa4e0175c27a57d328665f83ee9887, 2629, 106, 106, 0, 0, 106, 0, 0, 1.0, 5919, ss: 64 sss: 32 
0xf79af58431a760a977fe8911a3aef8ecc180d0f7, 1598, 110, 109, 1, 0, 110, 0, 0, 1.0, 29771, ss: 64 sss: 32 
0x718495979a46918f6f32bebaeab69965376bcc32, 1295, 83, 83, 0, 0, 83, 0, 0, 1.0, 13649, ss: 64 sss: 32 
0xf822662479ee7e6f7001443f7efe7a382359d90b, 2508, 172, 166, 6, 0, 172, 0, 0, 1.0, 71242, ss: 64 sss: 32 
0x4798d38df98373ee8474b95f6c9e517d6b81c7bc, 1592, 108, 108, 0, 0, 108, 0, 0, 1.0, 18391, ss: 64 sss: 32 
0xE8E01fCa3A262297CFF5C795D126AA088D65af0A, 1227, 92, 92, 0, 0, 92, 0, 0, 1.0, 8840, ss: 64 sss: 32 
0x5f24E4a1A1f134a5a6952A9965721E6344898497, 2513, 175, 172, 3, 0, 175, 0, 0, 1.0, 28809, ss: 64 sss: 32 
0xf5ca50556e5a15dbd32febbddee66d6378d42565, 745, 57, 57, 0, 0, 57, 0, 0, 1.0, 2199, ss: 64 sss: 32 
0xecacb305403ab288b0a2b11d6cd6481de4914b95, 1490, 103, 103, 0, 0, 103, 0, 0, 1.0, 17080, ss: 64 sss: 32 
0x375f842b65e5baa2d1ae9a99069d8f5e3bda94cb, 2047, 151, 150, 1, 0, 151, 0, 0, 1.0, 31680, ss: 64 sss: 32 
0x3c5590502e366cfd05cddc229205d1cfd9c99aa5, 1385, 110, 110, 0, 0, 110, 0, 0, 1.0, 22233, ss: 64 sss: 32 
0xcbe2cb2511e4fc2ca3552a65cf95324a5786c64f, 1492, 103, 103, 0, 0, 103, 0, 0, 1.0, 50004, ss: 64 sss: 32 
0x6e45b69467ec90ea7d221a87994b24306eb59070, 1490, 103, 103, 0, 0, 103, 0, 0, 1.0, 51239, ss: 64 sss: 32 
0xce7c55f268e899aaba3eb28748aa1d6f7f40afb0, 2037, 151, 150, 1, 0, 151, 0, 0, 1.0, 53252, ss: 64 sss: 32 
0xbcb9984758367e1d7d1e8784630ba41463a425e0, 1502, 103, 103, 0, 0, 103, 0, 0, 1.0, 25216, ss: 64 sss: 32 
0xda098c1f08d3fceea95b2750e0a1c5af1b4789e5, 2045, 151, 150, 1, 0, 151, 0, 0, 1.0, 55545, ss: 64 sss: 32 
0x713708fd0787f10355d683b8634b88342e2b9b17, 2059, 151, 150, 1, 0, 151, 0, 0, 1.0, 26033, ss: 64 sss: 32 
0xe3692b2E55Eb2494cA73610c3b027F53815CCD39, 1557, 120, 110, 10, 0, 120, 0, 1, 1.0, 2515, ss: 64 sss: 32 
0x10e533be02b57fe9448098e0cd8a728c64a67b2c, 1567, 103, 103, 0, 0, 103, 0, 0, 1.0, 15752, ss: 64 sss: 32 
0x9AB474407776E9739A831D6cC9717020b52a1664, 1315, 87, 87, 0, 0, 87, 0, 0, 1.0, 29998, ss: 64 sss: 32 
0xfa5e41483022b76d4f2414e020c4b6fcdcbb893b, 828, 82, 81, 1, 0, 82, 0, 0, 1.0, 4369, ss: 64 sss: 32 
0x44214aaca0a71cfd5918eeaffcfb3ec026ee7ec3, 1838, 89, 89, 0, 0, 89, 0, 0, 1.0, 2034, ss: 64 sss: 32 
0x0D374775E962c3608B8F0A4b8B10567DF739bb56, 730, 52, 48, 4, 0, 52, 0, 0, 1.0, 301, ss: 64 sss: 32 
0xb4741c6000e1785b030f70dde95f3fadbeccaa07, 1225, 87, 87, 0, 0, 87, 0, 0, 1.0, 11514, ss: 64 sss: 32 
0x36a04caffc681fa179558b2aaba30395cddd855f, 2761, 217, 210, 7, 0, 217, 0, 0, 1.0, 222, ss: 64 sss: 32 
0xb71aacfc5ea13184fda7c64140f7a8e226917ba2, 1433, 136, 121, 15, 0, 136, 0, 0, 1.0, 17497, ss: 64 sss: 32 
0xda46C0Dc2195d326284186b89AAb71ACFF56cC8e, 1966, 140, 139, 1, 0, 140, 0, 0, 1.0, 44282, ss: 64 sss: 32 
0x78e8eebc69179e7c55025a1639633cd5b220accd, 1100, 89, 85, 4, 0, 89, 0, 0, 1.0, 1326, ss: 64 sss: 32 
0x57136542BdC53aaf53bF519a6D28A6C8F7CEEB1c, 861, 58, 48, 10, 0, 58, 0, 0, 1.0, 178, ss: 64 sss: 32 
0x832d62eeb4e644e4492b44aa023c20e237bfebbb, 2792, 239, 227, 12, 0, 239, 0, 1, 1.0, 24684, ss: 64 sss: 32 
0x4096dc8773b8d8c4a4146f8d4295d4a1bddaab25, 664, 28, 28, 0, 0, 28, 0, 0, 1.0, 291, ss: 64 sss: 32 
0x368457ec2c9096b9ae9e30af1b20aa16ce422930, 425, 36, 36, 0, 0, 36, 0, 0, 1.0, 134, ss: 64 sss: 32 
0x6ed79dc61e5d99ce733edb55d83e42b94eea72b9, 1038, 84, 81, 3, 0, 84, 0, 0, 1.0, 9143, ss: 64 sss: 32 
0x92fc983c213b8bfb211f6207f33adfe113328327, 2683, 93, 93, 0, 0, 93, 0, 0, 1.0, 14313, ss: 64 sss: 32 
0x8ceb642c710d22bd40492a546f12985620b2be4a, 181, 6, 6, 0, 0, 6, 0, 0, 1.0, 42, ss: 64 sss: 32 
0xf1B59868697f3925b72889ede818B9E7ba0316d0, 1344, 109, 109, 0, 0, 109, 0, 0, 1.0, 3116, ss: 64 sss: 32 
0x3b400259B6E8D003C9973a79Fb9828fBA9Fb87a0, 167, 8, 6, 2, 0, 8, 0, 0, 1.0, 5, ss: 64 sss: 32 
0xdf494fd1f3a3377016539ed891b5d5deeb278eb8, 1596, 108, 108, 0, 0, 108, 0, 0, 1.0, 19646, ss: 64 sss: 32 
0xdab486824c4a98a21325a34a36ed95085ad7442e, 1586, 108, 108, 0, 0, 108, 0, 0, 1.0, 23640, ss: 64 sss: 32 
0x5e314e43426a74f1f8275aaff30f41acf988b880, 1215, 87, 87, 0, 0, 87, 0, 0, 1.0, 6445, ss: 64 sss: 32 
0xED9d16a9c15B47904F535abBFff3DAa2113dB560, 1490, 115, 115, 0, 0, 115, 0, 0, 1.0, 11609, ss: 64 sss: 32 
0x94e4d8a7dccc8f4956b4706d2a846e1601c420e1, 1011, 84, 81, 3, 0, 84, 0, 0, 1.0, 17263, ss: 64 sss: 32 
0xec4384f90257a1f43bd82deec6ad1b488ebb6d00, 159, 15, 15, 0, 0, 15, 0, 0, 1.0, 125, ss: 64 sss: 32 
0xB1025b600Eae0373E7761Ab2Fd88c705e2798FA6, 2437, 153, 151, 2, 0, 153, 0, 0, 1.0, 28893, ss: 64 sss: 32 
0xc9e358259e325bcb96abe0eeebeddc46559ac20c, 2681, 93, 93, 0, 0, 93, 0, 0, 1.0, 4026, ss: 64 sss: 32 
0x5cd21eba15cc71714c374da86b5308493f7a256a, 1575, 103, 103, 0, 0, 103, 0, 0, 1.0, 26817, ss: 64 sss: 32 
0xb663945fc96656ad9f5b7ad1561182aca7071592, 1593, 108, 108, 0, 0, 108, 0, 0, 1.0, 40148, ss: 64 sss: 32 
0xbec0ed4a1914d1fb3077d8e1fefb6bf18e77c2dc, 919, 54, 54, 0, 0, 54, 0, 0, 1.0, 2281, ss: 64 sss: 32 
0x7c032115bc32e118f7652411277d434ed1a2e120, 1385, 110, 110, 0, 0, 110, 0, 0, 1.0, 34547, ss: 64 sss: 32 
0x9f69ef68866ce4f74139ef9b134d3d3c2f0794f6, 1491, 103, 103, 0, 0, 103, 0, 0, 1.0, 24046, ss: 64 sss: 32 
0xc891738d5bd1b9b86b5b18839add3621de8b05fd, 240, 11, 11, 0, 0, 11, 0, 0, 1.0, 39, ss: 64 sss: 32 
0xc9097f9df7b07b0587f1745d045df47994647719, 1216, 87, 87, 0, 0, 87, 0, 0, 1.0, 13109, ss: 64 sss: 32 
0x10cf4547763e436991bae0bb23286ec1bb6a9ce2, 66, 6, 5, 1, 0, 6, 0, 0, 1.0, 33, ss: 64 sss: 32 
0xa1a7cc46d48f895f4c6a0274e30e50ebf64d564d, 1913, 147, 147, 0, 0, 147, 0, 0, 1.0, 17559, ss: 64 sss: 32 
0x528a7d60daf08a98e39220b1de6557be6afe9bbb, 715, 70, 70, 0, 0, 70, 0, 0, 1.0, 1437, ss: 64 sss: 32 
0x4096acdc3bb3c6a8bdd70a946515a07b465232c0, 1596, 110, 109, 1, 0, 110, 0, 0, 1.0, 52209, ss: 64 sss: 32 
0x17e713f4757fc30b99d18f1a0658470d117d8d05, 1594, 110, 109, 1, 0, 110, 0, 0, 1.0, 14531, ss: 64 sss: 32 
0x3c2e869bb072f8d57b7cc8806dc19f71cf8b036e, 1600, 110, 109, 1, 0, 110, 0, 0, 1.0, 32369, ss: 64 sss: 32 
0xcf6f65b8925b73d0289bf9c7f088dd57a8040629, 2667, 258, 236, 22, 0, 258, 0, 0, 1.0, 39940, ss: 64 sss: 32 
0x7699B9ACb26b9d05bd9091e14B28Ba57C1F0F5E8, 2527, 115, 110, 5, 0, 115, 0, 0, 1.0, 51409, ss: 64 sss: 32 
0xD846AA34caEf083DC4797d75096F60b6E08B7418, 1941, 138, 136, 2, 0, 138, 0, 0, 1.0, 17816, ss: 64 sss: 32 
0x38c48c3d8d88c17281462e39192615cdc25fe630, 250, 18, 18, 0, 0, 18, 0, 0, 1.0, 1706, ss: 64 sss: 32 
0x98b39E67F63E89C3CbbEb8EdED75374C906a1912, 1316, 87, 87, 0, 0, 87, 0, 0, 1.0, 12340, ss: 64 sss: 32 
0xdee5a9c375cca6b4a4a5e9655cef7136485f31b5, 2462, 170, 163, 7, 0, 170, 0, 0, 1.0, 65031, ss: 64 sss: 32 
0x298fabd16314e017fd67df916191ad23742a1ab7, 1581, 103, 103, 0, 0, 103, 0, 0, 1.0, 27947, ss: 64 sss: 32 
0x5b7279055048d435d70e86be71764de0a09e5b7f, 1489, 103, 103, 0, 0, 103, 0, 0, 1.0, 49311, ss: 64 sss: 32 
0x96d1f6eaa5a52b2eac0579be197bf519f2f05aa7, 1552, 103, 103, 0, 0, 103, 0, 0, 1.0, 37588, ss: 64 sss: 32 
0xa1b0f267cf5eab73eefdcaf1c52704772f99a37f, 1023, 84, 81, 3, 0, 84, 0, 0, 1.0, 22233, ss: 64 sss: 32 
0x1ec364CDD9697F56B8CB17a745B98C2b862CBE29, 2155, 146, 143, 3, 0, 146, 0, 0, 1.0, 30461, ss: 64 sss: 32 
0x01e7a3829eab007c79b2e49b009217ac94fcea6d, 1184, 98, 95, 3, 0, 98, 0, 0, 1.0, 15817, ss: 64 sss: 32 
0x84aE6D61Df5c6ba7196b5C76Bcb112B8a689aD37, 1889, 116, 112, 4, 0, 116, 0, 0, 1.0, 16270, ss: 64 sss: 32 
0x0eba910497ba4ca01e691d9bfe6823d8ec3457f5, 1591, 107, 106, 1, 0, 107, 0, 0, 1.0, 40930, ss: 64 sss: 32 
0x65e3214e1fb76e50b15c9032eba75a7441844cfd, 1030, 101, 101, 0, 0, 101, 0, 0, 1.0, 30654, ss: 64 sss: 32 
0xe29a8d906d01d667c5f735e1680f9c79685a7946, 685, 40, 40, 0, 0, 40, 0, 0, 1.0, 1468, ss: 64 sss: 32 
0xe846ec7087f879d7e08603696b2e8f2d706a0b51, 1478, 103, 103, 0, 0, 103, 0, 0, 1.0, 45266, ss: 64 sss: 32 
0xae427eb0bec7ad2ef79d1ae2a26b71d23ac81da0, 2571, 198, 196, 2, 0, 198, 0, 0, 1.0, 111668, ss: 64 sss: 32 
0xf518c72caa778ba9757b37b043a2c81e06e6ea7f, 470, 40, 40, 0, 0, 40, 0, 0, 1.0, 465, ss: 64 sss: 32 
0xa09a3e90da9574a43d35b893277ed6b3df79e88f, 2038, 151, 150, 1, 0, 151, 0, 0, 1.0, 60444, ss: 64 sss: 32 
0x334f34c0c9db9450a3b043c8578285c0b0897a32, 2687, 93, 93, 0, 0, 93, 0, 0, 1.0, 6507, ss: 64 sss: 32 
0xfc2bf4e3d77d8f95e3c0e5837b01d4720a04a6a0, 397, 23, 22, 1, 0, 23, 0, 0, 1.0, 74, ss: 64 sss: 32 
0x2172be858cd9703cfa4c1da64a323eac5ba96b49, 1392, 110, 110, 0, 0, 110, 0, 0, 1.0, 20586, ss: 64 sss: 32 
0x43a894336D23c2C79A958638e2c23C81AE4a9F96, 181, 8, 6, 2, 0, 8, 0, 0, 1.0, 12, ss: 64 sss: 32 
0x2aecf16ea4b4036123f43da94cf4e3e4d0a2a293, 1823, 90, 89, 1, 0, 90, 0, 0, 1.0, 5376, ss: 64 sss: 32 
0x46Fa005E07e51732778A3745145B0D29AD5d7167, 1937, 100, 87, 13, 0, 100, 0, 0, 1.0, 853, ss: 64 sss: 32 
0x8012d769c438f106604c64d16e6287af9323deab, 1580, 108, 108, 0, 0, 108, 0, 0, 1.0, 41689, ss: 64 sss: 32 
0xB138084CfDDDE661893b57A865F78ac62710F9B3, 2830, 263, 242, 21, 0, 263, 0, 0, 1.0, 19662, ss: 64 sss: 32 
0x6AEFD8d13D3D28709eA1Ee9A0DB0C3654DCebA8c, 2531, 116, 110, 6, 0, 116, 0, 0, 1.0, 43191, ss: 64 sss: 32 
0xc1024ef7448186d4792d7dec5497fe8d4241687c, 2017, 166, 156, 10, 0, 166, 0, 1, 1.0, 6880, ss: 64 sss: 32 
0xb052e1f0a856b062285bafeb5e192b7b67e047de, 1591, 108, 108, 0, 0, 108, 0, 0, 1.0, 22627, ss: 64 sss: 32 
0xC51e219951E9a76751E812A59e003A548803B9D8, 2231, 155, 153, 2, 0, 155, 0, 0, 1.0, 30888, ss: 64 sss: 32 
0x97a206f60438e92da0807b1c3182c390849f6b3d, 1249, 96, 96, 0, 0, 96, 0, 0, 1.0, 27607, ss: 64 sss: 32 
0xc862346614d4af4c0a3dff74cebf5a33f188ae73, 1484, 103, 103, 0, 0, 103, 0, 0, 1.0, 35098, ss: 64 sss: 32 
0x7ae5597218a4f55bc660e9f95514b5edecd90daf, 1887, 124, 124, 0, 0, 124, 0, 0, 1.0, 7712, ss: 64 sss: 32 
0x75272b96b7685834ef49b406e6a333ea28b10860, 1025, 85, 81, 4, 0, 85, 0, 0, 1.0, 10554, ss: 64 sss: 32 
0xfa15c2d3ab938fcc90f1f1009b1bda2b3f48c1d4, 1217, 87, 87, 0, 0, 87, 0, 0, 1.0, 4984, ss: 64 sss: 32 
0x5d02e188D7A922513F14b69D71af77c3B0Bc0551, 2535, 115, 110, 5, 0, 115, 0, 0, 1.0, 64915, ss: 64 sss: 32 
0x1aae838689be723c36efe59bee351d60b4f3f9ae, 1823, 89, 89, 0, 0, 89, 0, 0, 1.0, 2489, ss: 64 sss: 32 
0xd2fc2000e9bba1e700b7984db01ec8a881308ad5, 544, 62, 62, 0, 0, 62, 0, 0, 1.0, 906, ss: 64 sss: 32 
0xb30aef19a72d235090100795dacfaf529813f1f3, 1390, 110, 110, 0, 0, 110, 0, 0, 1.0, 12366, ss: 64 sss: 32 
0x3AD453aB9aEd17EBa23C4c4f8CeB18025CA6495a, 1996, 144, 143, 1, 0, 144, 0, 0, 1.0, 32960, ss: 64 sss: 32 
0x153b5b235717354e2a8c3a19a0af26128a142d59, 1503, 136, 125, 11, 0, 136, 0, 0, 1.0, 8364, ss: 64 sss: 32 
0xeac7de44477c46f5bba4147ad5a3a10fee93688c, 1219, 87, 87, 0, 0, 87, 0, 0, 1.0, 6098, ss: 64 sss: 32 
0xfb5Bc0af330e64964210f148C8B06fde190565Cd, 1898, 144, 136, 8, 0, 144, 0, 0, 1.0, 83251, ss: 64 sss: 32 
0x905ade25B1f8f39Cf470E39c5A768EAF1f91Fd3e, 1125, 70, 62, 8, 0, 70, 0, 0, 1.0, 30271, ss: 64 sss: 32 
0x6672e4027d7a42187c7e69b8ccf5927ead0e5b7b, 2593, 247, 231, 16, 0, 247, 0, 0, 1.0, 17374, ss: 64 sss: 32 
0xc044A45eb577A6F9Da46dcfb34EE3A68c1585837, 1324, 87, 87, 0, 0, 87, 0, 0, 1.0, 16609, ss: 64 sss: 32 
0x1cf2931af34a175d9cd3a27e8afa5746e277338c, 709, 69, 69, 0, 0, 69, 0, 0, 1.0, 12919, ss: 64 sss: 32 
0x7bce3751c2a595b30f73fe0b34ad7dbea51756d6, 1840, 89, 89, 0, 0, 89, 0, 0, 1.0, 11016, ss: 64 sss: 32 
0xbb86856e9ba03351c68953a6861ff30bdc1b9d9d, 1819, 90, 89, 1, 0, 90, 0, 0, 1.0, 2712, ss: 64 sss: 32 
0x6c11ccf62Ba347549eAD21A3390DFa43ea238D78, 1016, 84, 81, 3, 0, 84, 0, 0, 1.0, 22315, ss: 64 sss: 32 
0xE80CA594A2df9226Ad8cf582375eF00aa98B2884, 1900, 157, 151, 6, 0, 157, 0, 0, 1.0, 30972, ss: 64 sss: 32 
0x32e1bfd713d9fef8a5d1bc10592a2d0fc10b92ff, 1157, 117, 116, 1, 0, 117, 0, 0, 1.0, 17613, ss: 64 sss: 32 
0x9C1E6d460426a5e5355B337F67B5e4ffE916765E, 2392, 211, 208, 3, 0, 211, 0, 0, 1.0, 60840, ss: 64 sss: 32 
0x05b2c0c67c3384b831a56d48f8aca588c566b8dd, 1007, 84, 81, 3, 0, 84, 0, 0, 1.0, 25483, ss: 64 sss: 32 
0x517964d868560f6a0c5f9258c7fdf14d136abb96, 1496, 103, 103, 0, 0, 103, 0, 0, 1.0, 21908, ss: 64 sss: 32 
0xcd758a5e59d8e6293f8749370647bacbb5327fbb, 1537, 80, 72, 8, 0, 80, 0, 0, 1.0, 12596, ss: 64 sss: 32 
0xd4c89791ef0fade72eaac6475296320b5572b28e, 1427, 88, 81, 7, 0, 88, 0, 0, 1.0, 8064, ss: 64 sss: 32 
0xc0ed4685f365883efce05135e78f9e9e71fe194f, 1602, 110, 109, 1, 0, 110, 0, 0, 1.0, 15897, ss: 64 sss: 32 
0x6412816b834caa82d8be0c601ea4aa60ed97a871, 2799, 195, 187, 8, 0, 195, 0, 0, 1.0, 16544, ss: 64 sss: 32 
0xb7e0bba8aa5807167036151db807d9624fae2078, 818, 73, 73, 0, 0, 73, 0, 0, 1.0, 5889, ss: 64 sss: 32 
0x2cce3a267eeec5219ae66583f37876b39cb44eb9, 2321, 146, 144, 2, 0, 146, 0, 0, 1.0, 30564, ss: 64 sss: 32 
0xc70150188142fbfcbb90db05bffc31bccded3da5, 67, 2, 2, 0, 0, 2, 0, 0, 1.0, 16, ss: 64 sss: 32 
0x73A15FeD60Bf67631dC6cd7Bc5B6e8da8190aCF5, 730, 52, 48, 4, 0, 52, 0, 0, 1.0, 2622, ss: 64 sss: 32 
0x47a55198cd3f1b6dfa39e911f1dc20ecf9da9507, 1505, 103, 103, 0, 0, 103, 0, 0, 1.0, 25637, ss: 64 sss: 32 
0x7e81f954fa4f8877d45ce4867363e9c913599746, 1605, 110, 109, 1, 0, 110, 0, 0, 1.0, 44845, ss: 64 sss: 32 
0x5aA86e9558F7701A90f343D90e0bC55AEb0046Df, 2748, 177, 164, 13, 0, 177, 0, 0, 1.0, 18354, ss: 64 sss: 32 
0xd45f8eab03fd454b8a2b7fd9a2ad372825ea59a6, 2033, 151, 150, 1, 0, 151, 0, 0, 1.0, 23180, ss: 64 sss: 32 
0x83d23bccc19449a2f66de54ef4903535be284a09, 1822, 89, 89, 0, 0, 89, 0, 0, 1.0, 8468, ss: 64 sss: 32 
0xF9D2ec4b9b44B141097489CBf00C59c974c49238, 2204, 163, 162, 1, 0, 163, 0, 0, 1.0, 164929, ss: 64 sss: 32 
0x9a0E53ED366fF1CBb13Ac179887B6b9A2deb9c51, 2012, 143, 142, 1, 0, 143, 0, 0, 1.0, 66694, ss: 64 sss: 32 
0xa54d90d8132edef66599196fbc4f1b95702508bf, 536, 40, 40, 0, 0, 40, 0, 0, 1.0, 273, ss: 64 sss: 32 
0xed881fdc86fd928c48f199ac0d4f95e104011611, 2044, 190, 189, 1, 0, 190, 0, 0, 1.0, 102317, ss: 64 sss: 32 
0x5593f2f61E772d6153d0Eb9a2F0F51Bba7DCAB8a, 1902, 139, 137, 2, 0, 139, 0, 0, 1.0, 3455, ss: 64 sss: 32 
0xdc597a5fd1f90d2b529c7862f3eab5cbad2c6ce2, 207, 22, 22, 0, 0, 22, 0, 0, 1.0, 188, ss: 64 sss: 32 
0xb466E4c777d4A37c8fe0a2D47eF0D1FF5ca842A3, 1311, 87, 87, 0, 0, 87, 0, 0, 1.0, 14072, ss: 64 sss: 32 
0x3145a839da643bd2a8b5af0a03f1c5ca2fcc7862, 668, 55, 55, 0, 0, 55, 0, 0, 1.0, 4618, ss: 64 sss: 32 
0x1fd1b29b8e7e652dcd0ab9867482ed9d71efab87, 1326, 92, 91, 1, 0, 92, 0, 0, 1.0, 27903, ss: 64 sss: 32 
0x86b130298719F753808E96cA6540b684a2d21466, 72, 1, 1, 0, 0, 1, 0, 0, 1.0, 12, ss: 64 sss: 32 
0x647cf62b24cfafdf57f52cb55081aca156958f98, 1489, 103, 103, 0, 0, 103, 0, 0, 1.0, 19830, ss: 64 sss: 32 
0xF811580Cf0c6B4503652dF726f13b0aea84DF050, 1195, 119, 102, 17, 0, 119, 0, 0, 1.0, 4335, ss: 64 sss: 32 
0x72A3a1461A88E2785b0Fb19AcE6C6137502b3622, 2231, 170, 159, 11, 0, 170, 0, 0, 1.0, 48186, ss: 64 sss: 32 
0xf689818d07ac53488ced7fca5a79e1456a7d4695, 1056, 75, 75, 0, 0, 75, 0, 0, 1.0, 19528, ss: 64 sss: 32 
0xe44c3f63fd25c2b1b9a04d1a876e9b6438f2b442, 1574, 107, 106, 1, 0, 107, 0, 0, 1.0, 38526, ss: 64 sss: 32 
0xd0Ec91D5389b63E4d1faa59269366233b4050235, 980, 71, 69, 2, 0, 71, 0, 0, 1.0, 55572, ss: 64 sss: 32 
0x9264Ac4E52EDdb5D0fb345CAE8E47A8b420a96fd, 936, 62, 62, 0, 0, 62, 0, 0, 1.0, 6845, ss: 64 sss: 32 
0x0b03ff98663fa7b97edc1b305e66ebf193b1d9cc, 1573, 103, 103, 0, 0, 103, 0, 0, 1.0, 36430, ss: 64 sss: 32 
0x3fd78dc101ef657575a11aa70ea563fc1c9c30e5, 1607, 110, 109, 1, 0, 110, 0, 0, 1.0, 40440, ss: 64 sss: 32 
0xe22c1226d88672595aec3d476053140465638228, 1586, 107, 106, 1, 0, 107, 0, 0, 1.0, 31631, ss: 64 sss: 32 
0xfbbda7e8bdd468ead6b51f19427c435cbd459c3c, 370, 31, 31, 0, 0, 31, 0, 0, 1.0, 1233, ss: 64 sss: 32 
0xb97e163cE6A8296F36112b042891CFe1E23C35BF, 730, 52, 48, 4, 0, 52, 0, 0, 1.0, 1123, ss: 64 sss: 32 
0x3311ad94f1bb66a78dd073b3c7fad6619c551e01, 1789, 151, 139, 12, 0, 151, 0, 0, 1.0, 3268, ss: 64 sss: 32 
0xd215c87988c46c71a0532058ddff01c885eb015c, 1226, 87, 87, 0, 0, 87, 0, 0, 1.0, 16346, ss: 64 sss: 32 
0x88b0d61be1092a0aed7d5d0393246a242c5899f6, 961, 83, 83, 0, 0, 83, 0, 0, 1.0, 14776, ss: 64 sss: 32 
0x09d1341849319F46A1feF75575C3bDa339649295, 1806, 125, 120, 5, 0, 125, 0, 0, 1.0, 18533, ss: 64 sss: 32 
0x34504644b56cbe86b34f39e679c435d435f18747, 2048, 151, 150, 1, 0, 151, 0, 0, 1.0, 72441, ss: 64 sss: 32 
0x16a70939d9aeb729adc8da34b9ed63538a603c42, 1591, 110, 109, 1, 0, 110, 0, 0, 1.0, 18523, ss: 64 sss: 32 
0xde6e1F680C4816446C8D515989E2358636A38b04, 730, 52, 48, 4, 0, 52, 0, 0, 1.0, 276, ss: 64 sss: 32 
0xfeb669045652b62cEF47ecFd286d39e4730f51b3, 1315, 87, 87, 0, 0, 87, 0, 0, 1.0, 20192, ss: 64 sss: 32 
0x10bf82fe7c65f7c222b67cb2b5d84e0150cbebd9, 1394, 110, 110, 0, 0, 110, 0, 0, 1.0, 17865, ss: 64 sss: 32 
0xe3efc8bacda7b19f5d51c5daab9af682b2a66744, 2481, 126, 104, 22, 0, 126, 0, 0, 1.0, 656, ss: 64 sss: 32 
0x77a45fa1e6b6e6557c8aca6de2a4eb5557bc5881, 1586, 108, 108, 0, 0, 108, 0, 0, 1.0, 23907, ss: 64 sss: 32 
0x10ac3f60f0111e812f3274a1a51075be26ee39a1, 172, 11, 10, 1, 0, 11, 0, 0, 1.0, 33, ss: 64 sss: 32 
0xd5A8004Afd44A83e913f325f9b3C656977453704, 171, 8, 6, 2, 0, 8, 0, 0, 1.0, 22, ss: 64 sss: 32 
0xEBb2ecdae91F875D4f25f26D1494bba0c52a04bC, 1716, 155, 155, 0, 0, 155, 0, 0, 1.0, 29801, ss: 64 sss: 32 
0x024084d60a5fE572620aE9CE3178471F8fEEFfD2, 2513, 251, 248, 3, 0, 251, 0, 0, 1.0, 101656, ss: 64 sss: 32 
0x203b87e9b22a1b27a684cdb923d7646b12e39760, 298, 23, 23, 0, 0, 23, 0, 0, 1.0, 884, ss: 64 sss: 32 
0xb4066ded5bab002ca19fb49a2335926ae00e7b46, 1583, 108, 108, 0, 0, 108, 0, 0, 1.0, 53464, ss: 64 sss: 32 
0x62f2f56ade240ea712a86d7a73dd11e24ce61a51, 2674, 93, 93, 0, 0, 93, 0, 0, 1.0, 13253, ss: 64 sss: 32 
0xfb4e98a54710e1305043257e7c44c3cc67b0da3a, 1756, 124, 124, 0, 0, 124, 0, 0, 1.0, 15418, ss: 64 sss: 32 
0x1e2f66272d44ae720dffa8991c9694c1e4fa2d63, 1012, 84, 81, 3, 0, 84, 0, 0, 1.0, 20604, ss: 64 sss: 32 
0x8a83ff75acb48feaa1644eeabf5acebd71b60c80, 750, 88, 88, 0, 0, 88, 0, 0, 1.0, 4502, ss: 64 sss: 32 
0x891459b56cd7f82993a0f272f4979695db2a66e5, 1517, 127, 127, 0, 0, 127, 0, 0, 1.0, 37085, ss: 64 sss: 32 
0x00000000006756ce25b95124e0FC879Cc2B7F1DA, 1686, 164, 164, 0, 0, 164, 0, 0, 1.0, 10639, ss: 64 sss: 32 
0x55648Ddd02a912058ccd5d173ae42F779a141a54, 1187, 119, 102, 17, 0, 119, 0, 0, 1.0, 3324, ss: 64 sss: 32 
0x62fb2cdaf98b4851920548e991e14445721ad952, 1486, 103, 103, 0, 0, 103, 0, 0, 1.0, 69386, ss: 64 sss: 32 
0x04fabe1de8d972d3c4ce53d2dad8b73b86da8788, 1967, 184, 170, 14, 0, 184, 0, 0, 1.0, 18991, ss: 64 sss: 32 
0x48b3fd97730063f317b4d03a092dcaf8f49e8f70, 1824, 89, 89, 0, 0, 89, 0, 0, 1.0, 6597, ss: 64 sss: 32 
0xbe01Af16910183a72c332681FE239a91999aD670, 600, 38, 38, 0, 0, 38, 0, 0, 1.0, 4950, ss: 64 sss: 32 
0xd2c59781f1db84080a0592ce83fe265642a4a8eb, 233, 15, 15, 0, 0, 15, 0, 0, 1.0, 71, ss: 64 sss: 32 
0xce254c058294b26ed2ed74f5d6f32d2cc0eb305d, 1591, 110, 110, 0, 0, 110, 0, 0, 1.0, 11624, ss: 64 sss: 32 
0x390dD930a4D00Cb7b0D2CB19745B6C0Cfb0e3B73, 165, 16, 16, 0, 0, 16, 0, 0, 1.0, 63, ss: 64 sss: 32 
0x42BcCB90eCCDAe96F6435C82eEfdD2DA577659fc, 1903, 144, 143, 1, 0, 144, 0, 1, 1.0, 34407, ss: 64 sss: 32 
0xe6ad61f76209b9a15072f8cc26d7652e2687d7c0, 1211, 87, 87, 0, 0, 87, 0, 0, 1.0, 6673, ss: 64 sss: 32 
0xad98414815ef406da4631c9804ccfbedd3225035, 1028, 107, 107, 0, 0, 107, 0, 0, 1.0, 16578, ss: 64 sss: 32 
0x3B115AbA8D09d18dc80b0CA9fDC925BdF3606A5d, 2826, 262, 242, 20, 0, 262, 0, 0, 1.0, 42276, ss: 64 sss: 32 
0xa780801815E8384794278d02214cfCe645f4d1Ae, 70, 5, 5, 0, 0, 5, 0, 0, 1.0, 18, ss: 64 sss: 32 
0x25a919D38c5D395FCb1f9d9e8895B68C53F39fdC, 456, 38, 38, 0, 0, 38, 0, 0, 1.0, 179, ss: 64 sss: 32 
0xC0A152d0c78D335257F4cCd474213a702096d911, 1775, 146, 136, 10, 0, 146, 0, 1, 1.0, 2791, ss: 64 sss: 32 
0xbcf08597eceb2bcf012480e15d9c04f3861fbe89, 1923, 147, 147, 0, 0, 147, 0, 0, 1.0, 15653, ss: 64 sss: 32 
0x4d5898E723b51b42320D944B9ddFb333465196d4, 179, 8, 6, 2, 0, 8, 0, 0, 1.0, 16, ss: 64 sss: 32 
0x430e8453b0a33e0b1b092aa69f812d9227761ef2, 510, 25, 25, 0, 0, 25, 0, 0, 1.0, 92, ss: 64 sss: 32 
0x2bcdb73866d4a40a5fb9ef98e501dc1c0d95292c, 1388, 110, 110, 0, 0, 110, 0, 0, 1.0, 20655, ss: 64 sss: 32 
0x651c6cc4ebbe421319bae4eadf4fa769ff14bf3e, 1590, 110, 110, 0, 0, 110, 0, 0, 1.0, 41456, ss: 64 sss: 32 
0x4822D77A2D328115C4edEbe1c82F313b28f8c315, 882, 61, 61, 0, 0, 61, 0, 1, 1.0, 7432, ss: 64 sss: 32 
0x5eeb8de77af38cb5db17244742989ccd128e10f6, 1080, 107, 107, 0, 0, 107, 0, 0, 1.0, 7512, ss: 64 sss: 32 
0x14abed2dd5fb0390a98653e9079059cf19c1f4c2, 1384, 110, 110, 0, 0, 110, 0, 0, 1.0, 11237, ss: 64 sss: 32 
0x29dfe6138ceaf336c6662bab46fc46bb5a654f0f, 283, 16, 16, 0, 0, 16, 0, 0, 1.0, 56, ss: 64 sss: 32 
0x147aae07dF268817994FD674a4f69D493c283e24, 2211, 163, 153, 10, 0, 163, 0, 0, 1.0, 23648, ss: 64 sss: 32 
0x118492053f229e52da35c4095e255b6a245c2e34, 2843, 262, 242, 20, 0, 262, 0, 0, 1.0, 44122, ss: 64 sss: 32 
0x6849bc47e2c815e16d765c9500e1cd841f22b282, 1607, 110, 109, 1, 0, 110, 0, 0, 1.0, 35431, ss: 64 sss: 32 
0xb3d1E37784c884c197fB4a94D23b669620cae4c6, 2281, 215, 202, 13, 0, 215, 0, 0, 1.0, 24804, ss: 64 sss: 32 
0x71e454a66Df5c67a0C5AB61fc3c60953B6aeb67a, 1317, 87, 87, 0, 0, 87, 0, 0, 1.0, 41032, ss: 64 sss: 32 
0xd3DE54d9e424BF27b8259E69B205127722c771Cb, 562, 44, 44, 0, 0, 44, 0, 0, 1.0, 1335, ss: 64 sss: 32 
0x2a364CdDa802Aa76caEA873410E8263575f7D276, 1815, 89, 89, 0, 0, 89, 0, 0, 1.0, 7579, ss: 64 sss: 32 
0xbc36755e696ecf27f727a3ad8d75a55e09139321, 1828, 89, 89, 0, 0, 89, 0, 0, 1.0, 7682, ss: 64 sss: 32 
0xaAE0DBF0eebdB2D22587BeEE04732a4c7945F270, 2581, 197, 188, 9, 0, 197, 0, 0, 1.0, 25778, ss: 64 sss: 32 
0xF53417f66D0A0a39fa2e6db44876Fb9413422DDB, 2547, 211, 209, 2, 0, 211, 0, 0, 1.0, 117, ss: 64 sss: 32 
0x09D85676cbEe4fF1A521e2b8b907Dc82F0dcDb2D, 1425, 125, 119, 6, 0, 125, 0, 0, 1.0, 11402, ss: 64 sss: 32 
0x26391e51c32bd18f43df3678df87d5510d43ee36, 631, 36, 36, 0, 0, 36, 0, 0, 1.0, 4006, ss: 64 sss: 32 
0xa4bfa98a19d8b3830cd30ba9594af06df3537dbc, 1584, 110, 110, 0, 0, 110, 0, 0, 1.0, 16567, ss: 64 sss: 32 
0xe0f53faba6cbfb022b16c9da63a1e0bad0279332, 780, 82, 81, 1, 0, 82, 0, 0, 1.0, 2616, ss: 64 sss: 32 
0xd03d297d13a83a69abaa280feb8d44da83855c6a, 1489, 103, 103, 0, 0, 103, 0, 0, 1.0, 30850, ss: 64 sss: 32 
0xa55c8b69748e3ca39af80edc3e7a93abcc36afae, 1602, 110, 110, 0, 0, 110, 0, 0, 1.0, 15571, ss: 64 sss: 32 
0x752446c704ba6e9d261eb810a20f3f1514623e18, 1010, 84, 81, 3, 0, 84, 0, 0, 1.0, 21745, ss: 64 sss: 32 
0x20616748570be36403dc83e3dc4cece4082f6453, 1586, 108, 108, 0, 0, 108, 0, 0, 1.0, 16575, ss: 64 sss: 32 
0x5db6e8e85f635391a3bfa5e93126947af20ad05f, 1553, 103, 103, 0, 0, 103, 0, 0, 1.0, 35901, ss: 64 sss: 32 
0xC00DF57B3f0b80B58205627Bb1D2cD431c49e1A0, 2642, 209, 208, 1, 0, 209, 0, 0, 1.0, 145968, ss: 64 sss: 32 
0xdc2afdbf00f4bdb31d6c1e8b0b7588305f5847cd, 1587, 107, 107, 0, 0, 107, 0, 0, 1.0, 53190, ss: 64 sss: 32 
0x201c00ba25cAc8e8FC23F001B1b6095094998c31, 1380, 107, 103, 4, 0, 107, 0, 0, 1.0, 66, ss: 64 sss: 32 
0x8fa4bfaafB319a3e2359398B1Cad54ab5CF84414, 493, 43, 40, 3, 0, 43, 0, 0, 1.0, 3494, ss: 64 sss: 32 
0xa3Bb3866A0082bcDe11A081b7240B5c828c994f2, 2239, 166, 156, 10, 0, 166, 0, 0, 1.0, 34319, ss: 64 sss: 32 
0x7d3e4ad388f7f9cfcb6ae58a63777ef6fe076379, 2583, 185, 182, 3, 0, 185, 0, 0, 1.0, 37795, ss: 64 sss: 32 
0x1B4ad253a7dA87e3ECf738a046beF1D8e714cDf8, 2526, 115, 110, 5, 0, 115, 0, 0, 1.0, 54822, ss: 64 sss: 32 
0xd8e4ab3ac0d5376e6c3a3a7dd43eda557529a848, 1487, 103, 103, 0, 0, 103, 0, 0, 1.0, 48382, ss: 64 sss: 32 
0x41587f0de17E1Fb7e15d905eb2A0d0A300acbf6c, 2807, 195, 186, 9, 0, 195, 0, 0, 1.0, 44076, ss: 64 sss: 32 
0x1d59b95ad87f0f4e7e41169d3d85bcc5643ac018, 1026, 84, 81, 3, 0, 84, 0, 0, 1.0, 22033, ss: 64 sss: 32 
0x57f63ef099876ed555f5b7fe6f76392e1502eb19, 1895, 147, 147, 0, 0, 147, 0, 0, 1.0, 19379, ss: 64 sss: 32 
0x5FC6b84f877B9FFF371950e3e825AC182f3d398d, 2906, 176, 175, 1, 0, 176, 0, 0, 1.0, 226254, ss: 64 sss: 32 
0x55a51a884aad46425743d64873024d6002c8cee4, 1504, 109, 109, 0, 0, 109, 0, 0, 1.0, 41068, ss: 64 sss: 32 
0x2604a868be5d7e1e0d88d08507fe717376c9eff9, 1258, 68, 62, 6, 0, 68, 0, 0, 1.0, 1042, ss: 64 sss: 32 
0x16465a7163f546c2f4be688d65b9478026ef3545, 1582, 103, 103, 0, 0, 103, 0, 0, 1.0, 31122, ss: 64 sss: 32 
0xc09ea1201fa133c49c025ec0a8f54c2b9bc31a92, 2581, 185, 182, 3, 0, 185, 0, 0, 1.0, 35879, ss: 64 sss: 32 
0xd5ff9ae45e33c028ca1b726ec788e48a70cd5d79, 1590, 110, 109, 1, 0, 110, 0, 0, 1.0, 30638, ss: 64 sss: 32 
0x1a5b13ef713ba23f7bb17013d1c73797e1285f26, 2651, 191, 191, 0, 0, 191, 0, 0, 1.0, 87912, ss: 64 sss: 32 
0xfdf2239453185f15374bc54a4737bab22720acf7, 1382, 110, 110, 0, 0, 110, 0, 0, 1.0, 25741, ss: 64 sss: 32 
0xd5d882de64d5dcc1ae0c622c5489aa85b4ef67aa, 1578, 108, 108, 0, 0, 108, 0, 0, 1.0, 35905, ss: 64 sss: 32 
0xe591293151fFDadD5E06487087D9b0E2743de92E, 1123, 99, 97, 2, 0, 99, 0, 1, 1.0, 68615, ss: 64 sss: 32 
0xcee2fb44bfbd4305d1da245f14d94892eaaa5d95, 1277, 98, 98, 0, 0, 98, 0, 0, 1.0, 21084, ss: 64 sss: 32 
0xa39c5d7b7c0bf22830cd3da207712acaf5d3cbb7, 2792, 239, 227, 12, 0, 239, 0, 1, 1.0, 24235, ss: 64 sss: 32 
0x1ef14c4afbd73b2faf8a1f1bc31f088d4ce1d548, 608, 23, 23, 0, 0, 23, 0, 0, 1.0, 2474, ss: 64 sss: 32 
0xe532ee26641438c24a5409cdd5a707731052d8e5, 980, 38, 36, 2, 0, 38, 0, 0, 1.0, 2556, ss: 64 sss: 32 
0x31fea152f7d6a89543ea2e55f724311e3c09c036, 1816, 89, 89, 0, 0, 89, 0, 0, 1.0, 4681, ss: 64 sss: 32 
0xf7b265c2be85a4a5f9bd0ed4642f57b0eca7c530, 374, 31, 31, 0, 0, 31, 0, 0, 1.0, 269, ss: 64 sss: 32 
0x7485e7ae331c77d9edfc6d187aa9ec9779f03941, 1007, 84, 81, 3, 0, 84, 0, 0, 1.0, 17014, ss: 64 sss: 32 
0x23f8dec716699941bade7a3751dcb21000b29d39, 1817, 89, 89, 0, 0, 89, 0, 0, 1.0, 9338, ss: 64 sss: 32 
0x334aA5996583722cC850344eC02fD99bc263C56d, 1922, 139, 138, 1, 0, 139, 0, 0, 1.0, 50349, ss: 64 sss: 32 
0xcc3c9a1e2387c5e74698a3ac3ba91d905d996543, 1050, 103, 103, 0, 0, 103, 0, 0, 1.0, 8000, ss: 64 sss: 32 
0x71e9e74491de234d78a7da6d5ad2935148057e03, 1012, 84, 81, 3, 0, 84, 0, 0, 1.0, 23637, ss: 64 sss: 32 
0xaFE3C34D9fF9AAFEfD237323E1cde4d5eEE99cC5, 1828, 89, 89, 0, 0, 89, 0, 0, 1.0, 3978, ss: 64 sss: 32 
0x8ab8e01c5f96af1546a8d0b1df2107bdd5293bb4, 1489, 103, 103, 0, 0, 103, 0, 0, 1.0, 54465, ss: 64 sss: 32 
0x217547248d135d143b4c974168782d3906515eb9, 1004, 84, 81, 3, 0, 84, 0, 0, 1.0, 22387, ss: 64 sss: 32 
0x6540bfaa6b41f27a3dfb8fe5f44b9bd7b678c921, 1872, 152, 148, 4, 0, 152, 0, 0, 1.0, 24212, ss: 64 sss: 32 
0x25bb3d2f8db0776e68beb2b2ede7d6b229f374b7, 1602, 110, 109, 1, 0, 110, 0, 0, 1.0, 38108, ss: 64 sss: 32 
0x6810d3d295f24f7cd14ff0f006a16c6eb57b82fb, 1486, 103, 103, 0, 0, 103, 0, 0, 1.0, 47524, ss: 64 sss: 32 
0xc69ec3432f8cda053ddf761af3a724e75e99e08d, 1511, 110, 110, 0, 0, 110, 0, 0, 1.0, 31490, ss: 64 sss: 32 
0xc8a8efea810c1ee79d8669653d17d9de7c22ad30, 1900, 147, 147, 0, 0, 147, 0, 0, 1.0, 36587, ss: 64 sss: 32 
0xb12c05c7e540832d05c2007bb92088661232dc88, 2678, 93, 93, 0, 0, 93, 0, 0, 1.0, 11777, ss: 64 sss: 32 
0x361768d1cf41aa232eb6436d477505f446ee65b6, 1588, 108, 108, 0, 0, 108, 0, 0, 1.0, 46384, ss: 64 sss: 32 
0x7c84ac34fa5be7eb52ffe22a24df8fda8c238319, 1505, 103, 103, 0, 0, 103, 0, 0, 1.0, 44619, ss: 64 sss: 32 
0xf5ef38ad15fb41bf066ccd9b738a26462b3701d2, 1916, 147, 147, 0, 0, 147, 0, 0, 1.0, 31394, ss: 64 sss: 32 
0x750c08afe6468fb83986e5b5b222273fb925f881, 1171, 98, 95, 3, 0, 98, 0, 0, 1.0, 14759, ss: 64 sss: 32 
0x26bcf3a55ce2c176ca27d48aec76ee71090c0e18, 1172, 98, 95, 3, 0, 98, 0, 0, 1.0, 12112, ss: 64 sss: 32 
0xB617e1D89C99bFfccA472c682Ce18a1f070E5747, 1214, 92, 92, 0, 0, 92, 0, 0, 1.0, 21181, ss: 64 sss: 32 
0xeef45721f10d3b67008152350328154efa7cde8e, 2819, 124, 120, 4, 0, 124, 0, 0, 1.0, 113350, ss: 64 sss: 32 
0x1f47a4a4fc670b7368439fb959bde29b3ecdada6, 1583, 107, 106, 1, 0, 107, 0, 0, 1.0, 32959, ss: 64 sss: 32 
0x3e0b14f27de8334eada9432d33d3de58a35a0a8b, 1608, 110, 109, 1, 0, 110, 0, 0, 1.0, 29080, ss: 64 sss: 32 
0x89b607bdb24af5127f2ef0e15583aebaaf2d6808, 1585, 108, 108, 0, 0, 108, 0, 0, 1.0, 36770, ss: 64 sss: 32 
0xc36318df21171dc43428f57ebff9f2e0b213bb8c, 1486, 103, 103, 0, 0, 103, 0, 0, 1.0, 49980, ss: 64 sss: 32 
0xe3b07168cf4e33f1ba1bb8bacb801416aa21886b, 1604, 110, 109, 1, 0, 110, 0, 0, 1.0, 39956, ss: 64 sss: 32 
0x95E23260A144E17d14d43FaA84Ac92965feAA30F, 1265, 98, 98, 0, 0, 98, 0, 0, 1.0, 20908, ss: 64 sss: 32 
0x8a915282bab9985ea4c13ad35b53403644ebeace, 1328, 92, 91, 1, 0, 92, 0, 0, 1.0, 25636, ss: 64 sss: 32 
0x231608329b1a6dde9f3da31104714c4ad277fce7, 1271, 87, 87, 0, 0, 87, 0, 0, 1.0, 29413, ss: 64 sss: 32 
0xe036736e5e49b93e82af304e7b48a8c5d5ce7a53, 1493, 103, 103, 0, 0, 103, 0, 0, 1.0, 49177, ss: 64 sss: 32 
0x50a1f9378a318168d2b880ed5ed48a9ee70afc55, 1598, 110, 110, 0, 0, 110, 0, 0, 1.0, 27901, ss: 64 sss: 32 
0x3b2c26ec40dfcff1f9637ea9f937c52b333713e0, 1020, 84, 81, 3, 0, 84, 0, 0, 1.0, 19884, ss: 64 sss: 32 
0x160ed9a82bde7ef06308fdfc96a7ed35bb6dcdd1, 2045, 151, 150, 1, 0, 151, 0, 0, 1.0, 55929, ss: 64 sss: 32 
0x6af4e56f3031210158125fa89100785818aa31dc, 2941, 119, 119, 0, 0, 119, 0, 0, 1.0, 15923, ss: 64 sss: 32 
0xe3748b86a559fc91b66d957c26732feddfaf0785, 1503, 110, 110, 0, 0, 110, 0, 0, 1.0, 39005, ss: 64 sss: 32 
0x3efea1e5f8bbb0dbcd87e6ca7960cfb7c09d0ae9, 2129, 168, 161, 7, 0, 168, 0, 0, 1.0, 29849, ss: 64 sss: 32 
0x2e38dc1673cda87f65532b5a03053934a42abda1, 1025, 84, 81, 3, 0, 84, 0, 0, 1.0, 16939, ss: 64 sss: 32 
0x3ee4a5b965699d0706fa98c80855423f3f9d6c2c, 2073, 156, 156, 0, 0, 156, 0, 0, 1.0, 50898, ss: 64 sss: 32 
0x4b6737ba4faa7cece23b9fa0f50370a51ac7af16, 1590, 108, 108, 0, 0, 108, 0, 0, 1.0, 45177, ss: 64 sss: 32 
0xc6f7fa4510f26f88a053208f760926ce70fab451, 2045, 151, 150, 1, 0, 151, 0, 0, 1.0, 53557, ss: 64 sss: 32 
0x210dbb010d93c7f843f699190da4fc4064f95260, 494, 26, 26, 0, 0, 26, 0, 0, 1.0, 582, ss: 64 sss: 32 
0xbecc9bb2e970101dce5518b67b9ee85be62d85e0, 1480, 103, 103, 0, 0, 103, 0, 0, 1.0, 48435, ss: 64 sss: 32 
0xcb96c64c94573e3786ae19bd3ce09a78903b6950, 1583, 110, 110, 0, 0, 110, 0, 0, 1.0, 33655, ss: 64 sss: 32 
0x39bfC76cf7dd2c7B9F666E089e70D68D39D041E4, 588, 34, 34, 0, 0, 34, 0, 0, 1.0, 235, ss: 64 sss: 32 
0xcd3623c0a765b1a44cc1e2feedeb4bde34eae636, 1899, 147, 147, 0, 0, 147, 0, 0, 1.0, 26422, ss: 64 sss: 32 
0x185842355304ad4931100f24c0315293296c5392, 1550, 103, 103, 0, 0, 103, 0, 0, 1.0, 26018, ss: 64 sss: 32 
0xf687973a18915962acac67570ca267f45d875604, 900, 72, 72, 0, 0, 72, 0, 1, 1.0, 6054, ss: 64 sss: 32 
0xbc9D05517c10b14B241B6bB1c1149E337Fd80e4B, 645, 58, 58, 0, 0, 58, 0, 0, 1.0, 2932, ss: 64 sss: 32 
0x5aee15d83b50ab6909375242642ea3cedeb06b39, 1399, 110, 110, 0, 0, 110, 0, 0, 1.0, 22904, ss: 64 sss: 32 
0xC15091D3478296fD522B2807a9541578910DCC41, 705, 53, 52, 1, 0, 53, 0, 0, 1.0, 5553, ss: 64 sss: 32 
0x172A744e27B1Eb58BeCC028Ce7294Fd3e685A2Ae, 1355, 120, 118, 2, 0, 120, 0, 0, 1.0, 5772, ss: 64 sss: 32 
0x60d84B721293aa4C0D2Dc826068521Bd972f02E5, 183, 8, 6, 2, 0, 8, 0, 0, 1.0, 17, ss: 64 sss: 32 
0x2715770bd7b23165bc9ee82c4c865c73ad2f21b5, 2832, 198, 189, 9, 0, 198, 0, 0, 1.0, 55682, ss: 64 sss: 32 
0x826f1a1c427b32fa32c449df12b815f88dc55dc8, 1008, 84, 81, 3, 0, 84, 0, 0, 1.0, 14579, ss: 64 sss: 32 
0xce6f6d4897b85c4977052fcfa7d48657850415e3, 1498, 110, 110, 0, 0, 110, 0, 0, 1.0, 31911, ss: 64 sss: 32 
0xda1266b512baecfed27b5bfa47f403da9507628b, 1579, 103, 103, 0, 0, 103, 0, 0, 1.0, 19275, ss: 64 sss: 32 
0x8fb57bade1d83136803887071caefba116086aa8, 1213, 87, 87, 0, 0, 87, 0, 0, 1.0, 11631, ss: 64 sss: 32 
0xaf4c6752feff6572615445ae4d2335abde418df1, 1614, 110, 109, 1, 0, 110, 0, 0, 1.0, 22495, ss: 64 sss: 32 
0x3d0c6aff559ada6bfaa911b092e6c2ae4eb5505b, 1352, 81, 80, 1, 0, 81, 0, 0, 1.0, 2720, ss: 64 sss: 32 
0x05Be534AfEfFDe5ff66e44696b35C2dC0fCDfF90, 1703, 148, 148, 0, 0, 148, 0, 0, 1.0, 21333, ss: 64 sss: 32 
0x9EB0f9702e9bd1D478B4F027120CB5659cc999b8, 2228, 178, 173, 5, 0, 178, 0, 0, 1.0, 87709, ss: 64 sss: 32 
0x5c3596cedb2396d9fe88171decbeda5eebf0c5a9, 1263, 98, 98, 0, 0, 98, 0, 0, 1.0, 13203, ss: 64 sss: 32 
0xb2695d83b8fdd7d7b20e54318e8bda89e97e2391, 1022, 84, 81, 3, 0, 84, 0, 0, 1.0, 17142, ss: 64 sss: 32 
0x2c25d88e6dea171a32d15893e975409046c806b7, 1014, 84, 81, 3, 0, 84, 0, 0, 1.0, 10626, ss: 64 sss: 32 
0x94729784657b556370438597c7929110641c29c9, 825, 83, 83, 0, 0, 83, 0, 0, 1.0, 11708, ss: 64 sss: 32 
0xb33B94A471dA5d54bfC40C80D43b1F4Fc5F4D14D, 1311, 87, 87, 0, 0, 87, 0, 0, 1.0, 27021, ss: 64 sss: 32 
0x40069889098cd54D6c1021578000F37b197479Cf, 2377, 177, 165, 12, 0, 177, 0, 0, 1.0, 39916, ss: 64 sss: 32 
0x0b6177141fb299f448c96211ad8ca21f7a3ffb41, 1580, 109, 109, 0, 0, 109, 0, 0, 1.0, 36238, ss: 64 sss: 32 
0xc823813B27855356E0556859a2f1a7548dBedE71, 2527, 115, 110, 5, 0, 115, 0, 0, 1.0, 47379, ss: 64 sss: 32 
0x3E3B53A5a38e843ec54f2813A530418e8EBF8e1d, 948, 73, 73, 0, 0, 73, 0, 0, 1.0, 2372, ss: 64 sss: 32 
0x1d4ff8afe044b688d38f06374262530bead617e3, 1502, 110, 110, 0, 0, 110, 0, 0, 1.0, 36220, ss: 64 sss: 32 
0x11d6d434fdff93bfc3a1e9c2923e669939fff73e, 705, 72, 72, 0, 0, 72, 0, 0, 1.0, 3765, ss: 64 sss: 32 
0x81538c473291864419bfbf565c674c9d1f26ce1d, 1285, 98, 98, 0, 0, 98, 0, 0, 1.0, 13010, ss: 64 sss: 32 
0x790888d358963e0dd6ad3036cf40db2297f4d5f8, 1583, 108, 108, 0, 0, 108, 0, 0, 1.0, 18487, ss: 64 sss: 32 
0x9174e29ca6552486b250507a2677b5224cf77c13, 1589, 107, 106, 1, 0, 107, 0, 0, 1.0, 27515, ss: 64 sss: 32 
0xd3bd47d109fabe717dea185b9f337b258cf0eec7, 1596, 110, 110, 0, 0, 110, 0, 0, 1.0, 42166, ss: 64 sss: 32 
0x9dDA9063D5b86CD3fa5Fa316fE0B0E9bd2f85A41, 2186, 143, 139, 4, 0, 143, 0, 0, 1.0, 45731, ss: 64 sss: 32 
0x89682e5F9bf69C909FC5E21a06495ac35E3671Ab, 2414, 175, 172, 3, 0, 175, 0, 0, 1.0, 12343, ss: 64 sss: 32 
0x8bcb530bcba57ed9889f29afb58772a28183f227, 1816, 94, 89, 5, 0, 94, 0, 0, 1.0, 5531, ss: 64 sss: 32 
0x960b068dbaf5348d1303e8ac51f56636e481146f, 636, 53, 53, 0, 0, 53, 0, 0, 1.0, 2320, ss: 64 sss: 32 
0xEF75e83633E686D3085b3a988b937D021e2fA628, 2203, 151, 147, 4, 0, 151, 0, 0, 1.0, 10545, ss: 64 sss: 32 
0xc760b9FD3131a80131C2D79BcaB7E3A589063169, 186, 8, 6, 2, 0, 8, 0, 0, 1.0, 17, ss: 64 sss: 32 
0x4a487fe7f26a9ff521797c13cc2238c8d7cfc1b8, 1578, 107, 106, 1, 0, 107, 0, 0, 1.0, 29237, ss: 64 sss: 32 
0xb05f23BcD2e0713062b22c641F03591B101fBD94, 2535, 115, 110, 5, 0, 115, 0, 0, 1.0, 45225, ss: 64 sss: 32 
0xee698678f5c5cbc9c5b938326b3e6d15b113d345, 1599, 110, 110, 0, 0, 110, 0, 0, 1.0, 25061, ss: 64 sss: 32 
0x723c27c91e88909dbd0e8033fda53a85b2500231, 1209, 87, 87, 0, 0, 87, 0, 0, 1.0, 13020, ss: 64 sss: 32 
0x82ab67ad6fb9a08304c0628614b9e3ebe0771054, 1598, 110, 110, 0, 0, 110, 0, 0, 1.0, 19847, ss: 64 sss: 32 
0x0a976384d68039C311bD8a4bb9711451c2001A43, 1329, 87, 87, 0, 0, 87, 0, 0, 1.0, 28040, ss: 64 sss: 32 
0x01ad560dFc0c71d1349A4BF18F51aBc3eCeAF48e, 2487, 231, 222, 9, 0, 231, 0, 0, 1.0, 18321, ss: 64 sss: 32 
0x5CDE9fec66D89B931fB7a5DB8cFf2cDb642f4e7d, 801, 68, 64, 4, 0, 68, 0, 0, 1.0, 302, ss: 64 sss: 32 
0xcccce6a0eeccf30cc2a822d86d818348f62dfbc8, 1609, 110, 109, 1, 0, 110, 0, 0, 1.0, 18699, ss: 64 sss: 32 
0x6Cc65bF618F55ce2433f9D8d827Fc44117D81399, 2415, 140, 133, 7, 0, 140, 0, 0, 1.0, 7812, ss: 64 sss: 32 
0xb1ab9165d4e6ac613f3c1f880ee9fb4c3aaf90fe, 2807, 195, 187, 8, 0, 195, 0, 0, 1.0, 18059, ss: 64 sss: 32 
0x10350ac44c0d3f6c4abd55d32409ac31d4bd5087, 1893, 147, 147, 0, 0, 147, 0, 0, 1.0, 26112, ss: 64 sss: 32 
0xeb79563d45fb4a0a0513b9d4dec3944aaf53ac20, 1227, 87, 87, 0, 0, 87, 0, 0, 1.0, 13887, ss: 64 sss: 32 
0x0000000000004250039d1cf730bdd00b31942d18, 1481, 95, 94, 1, 0, 95, 0, 0, 1.0, 2596, ss: 64 sss: 32 
0xfbd2ad20e3a1d2afdbf92c269d0f219223e16aa5, 1196, 99, 95, 4, 0, 99, 0, 0, 1.0, 6402, ss: 64 sss: 32 
0xf367f3694231ffe9ccbb4c54b1047a91df815a63, 1004, 84, 81, 3, 0, 84, 0, 0, 1.0, 10068, ss: 64 sss: 32 
0x8f441d5880361fff1da43f4909b5b4ebf5dec99a, 1020, 84, 81, 3, 0, 84, 0, 0, 1.0, 19338, ss: 64 sss: 32 
0x4fb610a0be1965b943ee17df7c7d80071835e056, 705, 38, 38, 0, 0, 38, 0, 0, 1.0, 321, ss: 64 sss: 32 
0x7815b560979F112321676dfBF95CFaf978Af45a4, 1816, 89, 89, 0, 0, 89, 0, 0, 1.0, 1618, ss: 64 sss: 32 
0xa4d6262a3be1a5f25716d26e69218917cb200adc, 1522, 127, 127, 0, 0, 127, 0, 0, 1.0, 22531, ss: 64 sss: 32 
0xe7db0c55c8a6d7d5c21696dd41570e344f0bfd63, 1829, 89, 89, 0, 0, 89, 0, 0, 1.0, 5470, ss: 64 sss: 32 
0xba4aec451ccd4cec1664c1ad9fe06af219a0e18c, 1221, 120, 119, 1, 0, 120, 0, 0, 1.0, 11741, ss: 64 sss: 32 
0x8142709896850e5532983f25a26e36dcc3eab5fc, 697, 69, 69, 0, 0, 69, 0, 0, 1.0, 6610, ss: 64 sss: 32 
0xa24d3886be3557782eeffb5f6ac6a4bb24faff55, 1574, 107, 106, 1, 0, 107, 0, 0, 1.0, 14146, ss: 64 sss: 32 
0x51a2df312e19e1a144622e75fb5a04de97fb9d96, 2587, 247, 231, 16, 0, 247, 0, 0, 1.0, 47343, ss: 64 sss: 32 
0xbf19dd68189eabd4eb3de656e6c04a7df7b271bc, 1388, 110, 110, 0, 0, 110, 0, 0, 1.0, 19794, ss: 64 sss: 32 
0x58427ae12C559a5376918b11ce0C88564452ecE6, 2215, 143, 139, 4, 0, 143, 0, 0, 1.0, 27626, ss: 64 sss: 32 
0x2092202d26417fd0aa4e3802e7ce339f8e8f0695, 2743, 181, 173, 8, 0, 181, 0, 0, 1.0, 72436, ss: 64 sss: 32 
0x448DA008c7EB2501165c9Aa62DfFEeC4405bC660, 2968, 126, 125, 1, 0, 126, 0, 0, 1.0, 23058, ss: 64 sss: 32 
0x9d9ed0d05b17e4261cd2c1a8ed418c1000c44b17, 1578, 110, 110, 0, 0, 110, 0, 0, 1.0, 21104, ss: 64 sss: 32 
0x11839659D673C6c3D27E0f8E54Fd3370bD872F87, 2159, 139, 136, 3, 0, 139, 0, 0, 1.0, 9110, ss: 64 sss: 32 
0x8c13581ad0473869e0833a65d67b3912de1017ff, 1514, 110, 110, 0, 0, 110, 0, 0, 1.0, 16196, ss: 64 sss: 32 
0x9983ff02d5d85ce3da32e563dc9deab799067a75, 1224, 87, 87, 0, 0, 87, 0, 0, 1.0, 7239, ss: 64 sss: 32 
0xb6fca2e2837b87060b30672da71e1bbec0dc774b, 2798, 239, 227, 12, 0, 239, 0, 1, 1.0, 9305, ss: 64 sss: 32 
0x7b8f9D1f7444C86A1263C4A88f56A0471320b103, 1569, 103, 103, 0, 0, 103, 0, 0, 1.0, 18232, ss: 64 sss: 32 
0x99d0947aa396f305071f357fc74998740e5c1a81, 1588, 108, 108, 0, 0, 108, 0, 0, 1.0, 14401, ss: 64 sss: 32 
0x9cfd5e0aed87c614e218aeb3da4728c281f36997, 1588, 108, 108, 0, 0, 108, 0, 0, 1.0, 38238, ss: 64 sss: 32 
0xF0A3c2D4E81ACcc8e3Ac3aCCd50F5294601f88Cf, 2525, 115, 110, 5, 0, 115, 0, 0, 1.0, 29370, ss: 64 sss: 32 
0x833d4379940f3b30b0d258d3fd1258ad51222e0c, 2061, 151, 150, 1, 0, 151, 0, 0, 1.0, 50600, ss: 64 sss: 32 
0x3e0e7d1388338556a707d3bb6ebfd1bdef9618f3, 1495, 103, 103, 0, 0, 103, 0, 0, 1.0, 46483, ss: 64 sss: 32 
0xE1b45a7FB3643e14e297f915789e24CE7C3Fd19F, 2418, 177, 176, 1, 0, 177, 0, 0, 1.0, 467023, ss: 64 sss: 32 
0xf37e918697635c0eed40979ec3cbd1298347f66c, 1110, 83, 83, 0, 0, 83, 0, 0, 1.0, 23187, ss: 64 sss: 32 
0x06e29544bd4e9548d16c7a043adfa6b1567defe1, 425, 44, 44, 0, 0, 44, 0, 0, 1.0, 394, ss: 64 sss: 32 
0xE6685f9C0CA08e6D12bb83281629a32204eEAb48, 2267, 168, 156, 12, 0, 168, 0, 0, 1.0, 29956, ss: 64 sss: 32 
0xe5C9e4097cb26CA0dbF615c1113d9BE1aa7B50B9, 882, 54, 49, 5, 0, 54, 0, 0, 1.0, 354, ss: 64 sss: 32 
0xba630A7457f110211d9543f5D2D59233e9E4754d, 1305, 98, 98, 0, 0, 98, 0, 0, 1.0, 18447, ss: 64 sss: 32 
0x04729ae5f2b39709e4a7b20903566e1c6bca19c2, 1892, 147, 147, 0, 0, 147, 0, 0, 1.0, 27391, ss: 64 sss: 32 
0xa8ba8d813b8a952cdc87e27480e8645c36e3e671, 2362, 173, 173, 0, 0, 173, 0, 0, 1.0, 49312, ss: 64 sss: 32 
0xf38db58994ead8c00ee4c7b1ce5b1972263bdeb7, 1009, 85, 81, 4, 0, 85, 0, 0, 1.0, 17188, ss: 64 sss: 32 
0x352af70cdae5bd9772b823f96310c4d0a801f27e, 1483, 103, 103, 0, 0, 103, 0, 0, 1.0, 37745, ss: 64 sss: 32 
0x8b42012324157ef46b7cf401364a89eeb28d6fb5, 1499, 103, 103, 0, 0, 103, 0, 0, 1.0, 37814, ss: 64 sss: 32 
