Smart Contract, Total Opcodes, Total Jumps, Solved Jumps, Definitely unreachable jumps, Maybe unreachable jumps, Total solved Jumps, Unsound jumps, Maybe unsound jumps, % Total Solved, Time (millis), Time lost to get Storage, Actual time, Notes 
0xDcfCcaf54CB8c7c30bb7959929AbA24bF136FF57, 2936, 275, 238, 37, 0, 275, 0, 0, 1.0, 3689, 0, 3689, ss: 32 sss: 8 
0x5b348ec54c290683697f6a812ca1bfbb0e74c70d, 1496, 107, 103, 4, 0, 107, 0, 0, 1.0, 1075, 0, 1075, ss: 32 sss: 8 
0x9a1ba1687c2759fe96bfacbfb5300458b7d726f0, 1496, 107, 103, 4, 0, 107, 0, 0, 1.0, 1027, 0, 1027, ss: 32 sss: 8 
0x4582b79844e753ed53928d8b8761e9f27eb22735, 2543, 230, 202, 28, 0, 230, 0, 0, 1.0, 3665, 0, 3665, ss: 32 sss: 8 
0x60f19fd1f15fc08a1ea27d407dae25c4e7937547, 622, 53, 53, 0, 0, 53, 0, 0, 1.0, 149, 0, 149, ss: 32 sss: 8 
0x1370e65e0228b27566a5cb7328160794001f8651, 2404, 226, 206, 20, 0, 226, 0, 0, 1.0, 2831, 0, 2831, ss: 32 sss: 8 
0x0dcd1b77ef4459c37551b3a3fa4a8e1f2485ad08, 1496, 107, 103, 4, 0, 107, 0, 0, 1.0, 998, 0, 998, ss: 32 sss: 8 
0x16eA5Db6A7C2A72749a7f7600CAA64c97468D50E, 776, 51, 48, 3, 0, 51, 0, 0, 1.0, 95, 0, 95, ss: 32 sss: 8 
0x5a67e970cc210d6b5fb6512d8142e3eb648c1d32, 2838, 247, 223, 24, 0, 247, 0, 0, 1.0, 4370, 0, 4370, ss: 32 sss: 8 
0xb04862d030a38c351e8ecae09508cd30f80d88e3, 1351, 66, 63, 3, 0, 66, 0, 0, 1.0, 75, 0, 75, ss: 32 sss: 8 
0x6ea4f5bcd17185c5958677569340e39ac6364e9f, 1496, 107, 103, 4, 0, 107, 0, 0, 1.0, 1088, 0, 1088, ss: 32 sss: 8 
0xced519a9e7555dee0399f8da3019d8d557a88f81, 1542, 103, 99, 4, 0, 103, 0, 0, 1.0, 481, 0, 481, ss: 32 sss: 8 
0x2fa57c80249b0683c443043aB01b894125876AfC, 1445, 117, 113, 4, 0, 117, 0, 0, 1.0, 762, 0, 762, ss: 32 sss: 8 
0x0c6b8078d27c9729fad5db98c331291bf57ec879, 1496, 107, 103, 4, 0, 107, 0, 0, 1.0, 1006, 0, 1006, ss: 32 sss: 8 
0x2cfC31b4e1E838453c22675F46bB248AC9DDD439, 2936, 275, 238, 37, 0, 275, 0, 0, 1.0, 3862, 0, 3862, ss: 32 sss: 8 
0x33f9704b980a21b776eac1d9d4111db33ab6dfda, 1413, 101, 97, 4, 0, 101, 0, 0, 1.0, 1039, 0, 1039, ss: 32 sss: 8 
0x9960012D71d2085516646B411925AD1d115ED01F, 154, 8, 6, 2, 0, 8, 0, 0, 1.0, 2, 0, 2, ss: 32 sss: 8 
0x7Afa3d0E44046C7ce8094dC429305A7ff3706D10, 154, 8, 6, 2, 0, 8, 0, 0, 1.0, 2, 0, 2, ss: 32 sss: 8 
0xcbe2cb2511e4fc2ca3552a65cf95324a5786c64f, 1468, 103, 99, 4, 0, 103, 0, 0, 1.0, 822, 0, 822, ss: 32 sss: 8 
0xc4772Be15F0483672CD5f16CA06456c46908B61c, 2094, 106, 103, 3, 0, 106, 0, 0, 1.0, 1893, 0, 1893, ss: 32 sss: 8 
0xfdf37696ba7b6f96efda6109fab72a1351c2e33a, 2236, 151, 143, 8, 0, 151, 0, 0, 1.0, 1162, 0, 1162, ss: 32 sss: 8 
0x37c1f2469d510449a847e4e5c48607a2fc9aa223, 1180, 85, 84, 1, 0, 85, 0, 0, 1.0, 664, 0, 664, ss: 32 sss: 8 
0xce85d05d57c4b16a09de0133c2abedf1bfeea57c, 1342, 96, 90, 6, 0, 96, 0, 0, 1.0, 814, 0, 814, ss: 32 sss: 8 
0xd5a14d1846de1ad342853b79d1b5ef344c4973ef, 1496, 107, 103, 4, 0, 107, 0, 0, 1.0, 1063, 0, 1063, ss: 32 sss: 8 
0xcc0eab15b35cf04b57db2bb1f9237cd782115bdc, 2775, 218, 196, 22, 0, 218, 0, 0, 1.0, 2019, 0, 2019, ss: 32 sss: 8 
0x7699B9ACb26b9d05bd9091e14B28Ba57C1F0F5E8, 2459, 115, 103, 12, 0, 115, 0, 0, 1.0, 1552, 0, 1552, ss: 32 sss: 8 
0x3f121b9a6bc33b6c9f711ccbcaac67459c875641, 1496, 107, 103, 4, 0, 107, 0, 0, 1.0, 1100, 0, 1100, ss: 32 sss: 8 
0xb663945fc96656ad9f5b7ad1561182aca7071592, 1555, 108, 105, 3, 0, 108, 0, 0, 1.0, 911, 0, 911, ss: 32 sss: 8 
0x9248679610d7a502a069948278160c88239f123b, 1496, 107, 103, 4, 0, 107, 0, 0, 1.0, 1214, 0, 1214, ss: 32 sss: 8 
0x7f212c237699f3244da5ac025e12bcbf00d09357, 1322, 94, 88, 6, 0, 94, 0, 0, 1.0, 738, 0, 738, ss: 32 sss: 8 
0x5b7279055048d435d70e86be71764de0a09e5b7f, 1468, 103, 99, 4, 0, 103, 0, 0, 1.0, 839, 0, 839, ss: 32 sss: 8 
0x13b385a0cbc3296f14b342bad0e4fdf91ee08100, 2604, 187, 169, 18, 0, 187, 0, 0, 1.0, 970, 0, 970, ss: 32 sss: 8 
0x0a442ac10830f98e6f0485c6193490c5260e94b8, 2838, 247, 223, 24, 0, 247, 0, 0, 1.0, 4138, 0, 4138, ss: 32 sss: 8 
0xfa0460097248642d69bfb223bab5999507a8c23d, 1496, 107, 103, 4, 0, 107, 0, 0, 1.0, 993, 0, 993, ss: 32 sss: 8 
0xc053308c25597ac6447ccfbf25bb08bfdf03b596, 1343, 84, 79, 5, 0, 84, 0, 0, 1.0, 306, 0, 306, ss: 32 sss: 8 
0x3b7c618156f8cef53e123a66166aaf915b30ba3e, 1625, 114, 110, 4, 0, 114, 0, 0, 1.0, 723, 0, 723, ss: 32 sss: 8 
0x75b884711094aa9f407251892d28653d049fafbd, 1496, 107, 103, 4, 0, 107, 0, 0, 1.0, 1080, 0, 1080, ss: 32 sss: 8 
0xb0990e799314c516060b67a030fa5f5318baab69, 1640, 119, 112, 7, 0, 119, 0, 0, 1.0, 948, 0, 948, ss: 32 sss: 8 
0xe536920e8256d58Ca9356899bcc36C4F14E76a2c, 2915, 273, 236, 37, 0, 273, 0, 0, 1.0, 3322, 0, 3322, ss: 32 sss: 8 
0x306c0b64c39fb8924b026f6b9418d38278fc3c3f, 1373, 110, 101, 9, 0, 110, 0, 0, 1.0, 747, 0, 747, ss: 32 sss: 8 
0x7c6ECf809bc86518458fcC87CdC73B9a4289Cc40, 2936, 275, 238, 37, 0, 275, 0, 0, 1.0, 3670, 0, 3670, ss: 32 sss: 8 
0xcaa7f414906138a05051ecb759163dcc20514510, 2283, 159, 150, 9, 0, 159, 0, 0, 1.0, 1138, 0, 1138, ss: 32 sss: 8 
0xf7783e451fcbf7ccc2e15b7fee4f534b41ecd6e4, 1496, 107, 103, 4, 0, 107, 0, 0, 1.0, 987, 0, 987, ss: 32 sss: 8 
0x75272b96b7685834ef49b406e6a333ea28b10860, 995, 84, 78, 6, 0, 84, 0, 0, 1.0, 153, 0, 153, ss: 32 sss: 8 
0x3932f366886d2b981485503a182173da80d15c97, 1187, 90, 87, 3, 0, 90, 0, 0, 1.0, 724, 0, 724, ss: 32 sss: 8 
0xa25150b69733D6834628613E712934C279BEadF7, 1890, 171, 157, 14, 0, 171, 0, 0, 1.0, 1779, 0, 1779, ss: 32 sss: 8 
0xb30aef19a72d235090100795dacfaf529813f1f3, 1373, 110, 101, 9, 0, 110, 0, 0, 1.0, 756, 0, 756, ss: 32 sss: 8 
0x78791ee453093a33486a7a5c5e425f998f63a785, 1180, 85, 84, 1, 0, 85, 0, 0, 1.0, 666, 0, 666, ss: 32 sss: 8 
0x62fb2cdaf98b4851920548e991e14445721ad952, 1468, 103, 99, 4, 0, 103, 0, 0, 1.0, 761, 0, 761, ss: 32 sss: 8 
0xa151e7a30b805d399106bef9ee6b4a463232b643, 1496, 107, 103, 4, 0, 107, 0, 0, 1.0, 1022, 0, 1022, ss: 32 sss: 8 
